attack titan half season weeks fans series return action stakes time battle wall maria promises stories long returned ago wait definitely non much retake capitalize set beginning hiatus second third worth stop famous higher season wait series return famous stories 	season wait series return famous stories 
fan response attack titan hype season part episodes tv shows spot seemed enough much expected cracked rated imdb even belongs high bigger top highest recent fan hype episodes cracked shows 	fan hype episodes cracked shows 
episode list tv episodes hit series game thrones attack titan hero votes variety reasons fans characters life order colossal writing includes chernobyl pretty watched take highest ranked imdb major barry notable emotional biggest sacrifice highest ranked episode votes emotional 	highest ranked episode votes emotional 
attack titan midnight sun number votes game surprise boon popularity series arc characters action hotter season climax time fan episodes crack well episode sitting seen currently midst yet dying ever gearing top perfect last intense third good sure votes popularity series climax Attack Titan fan 	votes popularity series climax Attack Titan fan 
attack titan isayama series volumes set world remnants humanity city order escape danger titans race giants monsters eats humans character childhood friends fear crunchyroll funimation nights adult toonami block originally created collected live walled lead ends joining mikasa armin break survive trying save currently find streaming swim hajime last eren yeager military wall hometown saturday Attack Titan created volumes set Titans attack hometown 	Attack Titan created volumes set Titans attack hometown 
liverpool football club association britain team union associations competitions twelve trophies champions cup times super league formerly known europa english professional successful european uefa Liverpool Liverpool Football team trophies 	Liverpool Football team trophies 
qualification competitions team success league cup season liverpool seasons occasion heysel stadium disaster club champions times determined competed following banned readmitted successor europa european domestic previous consecutive final qualified uefa Qualification competed competitions seasons Stadium 	Qualification competed competitions seasons Stadium 
result victory champions liverpool champion clubs trophy outright winner badge wins competition times occasions teams leagues c milan league cup awarded bettered also super uefa final european multiple total sevilla real madrid victory result Champions League trophy awarded wins 	victory result Champions League trophy awarded wins 
bob paisley club manager trophies margin victory strřmsgodset cup winners competitions record gerrard goalscorer goals europe liverpool win jamie holds appearances successful biggest european carragher steven manager trophies win victory competitions appearances goalscorer goals 	manager trophies win victory competitions appearances goalscorer goals 
club competitions countries challenge cup clubs empire meet circumstances lipton trophy entrepreneur sportsman britain switzerland competition years attempt champion europe fc servette coupe des nations football leagues success reasons teams trace origins far back created sir named established lasted create made founded featured deemed abandoned different european austro hungarian normal thomas contested italy great germany earliest national swiss ten major due financial competitions Club teams countries attempt cup national champion clubs 	competitions Club teams countries attempt cup national champion clubs 
competition cup gabriel hanot editor l équipe winners football leagues liverpool division relegation season time competitions cities auspices europa league first organised conceived considered following thus created fairs established later branded came known continental uefa european national prestigious played second ineligible inter inaugurated domestic continental competition first national football leagues 	continental competition first national football leagues 
liverpool division years football league championship debut cup competitions winners formats champions amalgamation competition equivalent copa confederación sudamericana conmebol fifa club world confederations championships promoted later thus making following inaugurated originally match played established changed contested formerly latter libertadores jointly organised ran includes replaced first european uefa super europa intercontinental south american regional promoted First Division won championship debut 	promoted First Division won championship debut 
249 finished cutting damn toenails got bed damn shorts started getting damn playful came over bed started leaning over taking playful hell socks shoulder said go go New York 	cutting_toenails playful leaning_over bed socks_shoulder New_York 
250 sat goddam car gave another one playtul stupid little socks shoulder said car basketball coach one pets center team always let borrow car wanted 	sat_car playtul_socks basketball_coach pets center_team 
251 allowed students borrow faculty guys’ cars athletic bastards stuck together every school gone athletic bastards stick together 	borrow_cars faculty_guys’ athletic_bastards 
252 kept taking shadow punches shoulder toothbrush hand put mouth said time goddam car voice shaking something awful 	shadow_punches shoulder toothbrush time car voice_shaking awful 
253 thing say wash mouth soap professional secret buddy next part remember hot know got up bed like going something tried sock might right smack toothbrush would split goddam throat open missed 	wash_mouth soap professional_secret remember_hot up_bed right_smack missed 
254 connect sort get side head something probably hurt little bit much wanted probably hurt lot right hand make good fist hand account injury told 	side_head hurt right_hand good_fist injury 
255 the next thing knew on the goddam floor sitting on chest face red goddam knees on chest weighed ton hold wrists take another sock killed 	on_the_floor sitting_on_chest red_face knees_on_chest weighed_ton hold_wrists 
256 matter kept saying stupid race kept getting redder redder lousy knees chest told almost bawling really get offa ya crumby bastard 	redder knees chest 
257 though kept holding onto wrists kept calling sonuvabitch around ten hours hardly even remember said told thought could give time anybody felt like told even care girl kept kings back row reason care goddam stupid moron 	holding_wrists ten_hours hardly_remember care kings back_row stupid_moron reason 
258 hated called moron morons hate call moron 259 up said big stupid red face shut up even know first name ya goddam moron shut up damn warning ya really going shut up gonna slam ya one 	hated moron big_stupid red_face shut_up slam 
260 dirty stinking moron knees off chest letcha keep mouth shut even answer said letcha willya keep mouth shut got off got chest hurt like hell dirty knees dirty stupid sonuvabitch moron told 	dirty_knees moron off_chest mouth_shut chest_hurt dirty stupid 
261 got really mad shook big stupid finger face damn warning last time keep yap shut practically yelling trouble morons never want discuss anything way always tell moron never want discuss anything 	mad shook_finger face yap_shut yelling warning never_discuss 
262 really let one go the next thing knew on the goddam floor remember knocked out think pretty hard knock guy out except the goddam movies nose bleeding the place looked old standing practically right on top 	on_the_floor knocked_out bleeding_nose standing_on_top 
263 goddam toilet kit arm hell shut up tellya said sounded pretty nervous probably scared fractured skull something hit floor bad asked damn said look worried 	toilet_kit shut_up nervous scared fractured_skull hit_floor asked worried 
264 didn’t even bother get up lay floor kept calling moron sonuvabitch mad practically bawling wash face said hear 	didn’t_get_up calling_moron mad bawling wash_face hear 
265 told go wash moron pretty childish thing say mad hell told stop way give time janitor’s wife around 	wash_moron mad give_time janitor’s_wife 
266 kept sitting floor till heard old close door go corridor got up find goddam hunting hat anywhere found under bed put turned old peak around back way liked went took look stupid face mirror 	sitting_floor close_door corridor got_up hunting_hat under_bed peak_back stupid_face mirror 
267 never saw gore life blood mouth chin even pajamas bath robe partly scared partly fascinated blood sort made look tough two fights life lost not too tough pacifist want know truth 	gore blood_mouth scared_fascinated two_fights_life not_too_tough pacifist 
268 feeling old probably heard racket awake went shower curtains room see hell hardly ever went room always funny stink crumby personal habits 	racket awake shower_curtains funny_stink crumby personal_habits 
269 came shower curtains room could see lying bed knew damn well wide awake said pretty dark stepped shoe floor danm near fell head 	LIGHT shower_curtains lying_bed wide_awake dark shoe_floor fell_head 
270 sort sat bed leaned arm lot white stuff face pimples looked sort spooky dark hellya anyway said 	leaned_arm white_stuff face_pimples spooky_dark 
271 mean hell tryna sleep guys started making noise hell fight anyhow light find light sliding hand wall 	sleep noise fight find_light sliding_hand wall 
272 want light next hand finally found switch turned on put hand light hurt eyes said hell happened meant blood 	light_hurt_eyes switch_turned_on light blood hell 
273 little goddam tiff said sat floor never chairs room know hell chairs said feel like playing little Canasta Canasta fiend 	tiff sat_floor chairs playing_Canasta fiend 
274 still bleeding better put something stop wanna play little Canasta know time chance late around eleven around said gotta get go morning guys start hollering fighting middle hell fight about anyhow 	bleeding play_Canasta time eleven morning fighting fight_about 
275 long story wanna bore ya thinking welfare told never discussed personal life first place even stupid goddam genius next said okay sleep Ely’s bed tonight back till tomorrow night knew damn well went home damn near every week end 	long_story bore welfare personal_life stupid sleep Ely’s_bed 
276 know hell coming back said annoy hell mean know coming back never comes back till Sunday night tell somebody sleep goddam bed if want 	coming_back annoy Sunday_night sleep_if want 
277 killed reached sitting floor patted goddam shoulder prince kid said know mean tell somebody sleep 	killed patted_shoulder prince tell_somebody sleep 
278 real prince gentleman scholar kid said really happen cigarettes chance drop dead matter fact hell fight about 	real_prince gentleman scholar chance_cigarettes drop_dead fight_about 
279 answer got went looked window felt lonesome sudden almost wished dead hell fight about anyhow said about fiftieth time certainly bore about 	got up looked_window felt_lonesome wished_dead fight_about bore 
280 said defending goddam honor said lousy personality let get away stuff got excited kidding told kidding went laid bed feel rotten felt damn lonesome 	defending_honor lousy_personality excited kidding laid_bed feel_rotten lonesome 
281 room stinks said smell socks way ever send laundry like know said witty guy turning off goddam light 	room_stinks socks_smell laundry_ever witty_guy turning_off_light 
282 turn right away though kept laying bed thinking drove stark staring mad thought her parked somewhere car time thought felt like jumping window 	laying_bed staring_mad parked_car_her jumping_window felt 
283 thing know knew guys just talked sexual intercourse girls old really personally acquainted least two girls gave time to truth 	just_talked sexual_intercourse acquainted girls gave_time_to truth 
284 story fascinating life kid said turning off goddam light gotta get morning got turned off made happy laid bed 	story fascinating_life turned_off_light happy laid_bed 
285 ya gonna bed said perfect host boy may may not worry not worried hate like hell came sudden found 	perfect_host may_not may worried 
286 gonna sleep abuse goddam hospitality couple minutes later snoring like mad kept laying dark anyway though trying think old goddam car almost impossible 	sleep abuse_hospitality snoring_like_mad laying_dark impossible 
287 trouble knew guy technique made even worse car back date front mine technique guy start snowing date quiet sincere handsome guy nice sincere guy 	trouble technique double-dated back_car date snowing_quiet sincere handsome nice 
288 damn near puked listening date kept saying Please don’t Please old kept snowing sincere voice finally terrific silence back car really embarrassing don’t think gave girl time damn near 	puked Please_don’t sincere_voice silence back_car embarrassing near 
even depressing street even hear cars got feeling lonesome rotten even felt like waking said sort whisper hear shower curtain 	depressing_street cars lonesome rotten whisper shower_curtain 
didn’t hear though still didn’t hear slept like rock heard right matter said asleep routine joining monastery asked sort toying idea joining one 	didn’t_hear slept_rock asleep routine joining_monastery toying_idea 
bastard wake ask dumb go back sleep gonna join one anyway kind luck probably join one wrong kind monks stupid bastards bastards 	wake ask_dumb back_sleep luck wrong_monks 
said old sat way hell up bed said care say anything start making cracks goddam religion said making cracks goddam religion got up bed started towards door 	sat_bed cracks_religion got_up door 
want hang around stupid atmosphere stopped way though picked hand gave big phony handshake pulled away idea said 	stupid_atmosphere stopped picked_hand phony_handshake pulled_away idea 
idea want thank goddam prince said said sincere voice aces kid said know ”“Wise guy gonna bash even bother listen shut damn door went corridor 	thank_prince sincere_voice aces ”“Wise_guy bash shut_door corridor bother_listen 
asleep home week end quiet depressing corridor empty box toothpaste outside door walked towards stairs kept giving boot slipper thought thought might go see old 	asleep out home quiet depressing_corridor walked_stairs giving_boot 
sudden changed mind sudden decided really get hell out night mean wait till anything want hang around made sad lonesome decided decided take room hotel inexpensive hotel take easy till 	changed_mind get_out night sad lonesome hotel_room inexpensive_hotel 
go home rested feeling swell figured parents probably get old letter saying given ax till maybe want go home anything till got thoroughly digested want around first got mother gets hysterical 	go_home swell given_ax digested_letter hysterical_mother 
bad gets something thoroughly digested though sort needed little vacation nerves shot really decided went back room turned on light start packing already quite things packed even wake lit cigarette got dressed packed two took two minutes rapid packer 	digested needed_vacation shot_nerves room turned_on_light packing lit_cigarette rapid_packer 
thing packing depressed little pack ice skates mother practically sent couple days depressed could see mother going asking salesman million dopy getting ax 	packing depressed ice_skates mother_salesman getting_ax again 
made feel pretty sad bought wrong kind wanted racing skates bought made sad anyway every time somebody gives present ends making sad 	feel_sad wrong_skates present ends_sad 
got all packed sort counted dough remember exactly much pretty loaded sent wad week grandmother quite lavish dough 	all_packed counted_dough loaded grandmother_lavish 
marbles old keeps sending money birthday four times year even though pretty loaded figured could always use extra bucks never know 	marbles sending_money birthday four_times_year loaded extra_bucks 
went hail woke up guy lent typewriter asked much give pretty wealthy guy said know 	woke_up typewriter wealthy_guy 
set go bags stood next stairs took last look goddam corridor sort crying know put red hunting hat turned peak around back way liked yelled top goddam voice “Sleep tight ya morons bet woke every bastard whole floor 	bags stairs last_look corridor crying red_hunting_hat yelled “Sleep_tight morons 
got hell stupid guy thrown peanut shells stairs damn near broke crazy neck LATE call for cab anything walked whole way station far cold hell snow made hard for walking kept banging hell legs sort enjoyed air though trouble cold made nose hurt right upper 	stupid_guy thrown_peanut stairs broke_neck LATE_for_cab walked station cold snow 
lip old laid one smacked lip right teeth pretty sore ears nice warm though hat bought earlaps put give damn looked Nobody around anyway sack 	smacked_lip teeth sore warm_ears earlaps_hat Nobody_around 
quite lucky got station wait ten minutes train waited got snow hand washed face still quite bit blood 	lucky_station wait_train snow washed_face blood 
like riding on trains especially night lights on windows black one guys coming aisle selling coffee sandwiches magazines usually buy ham sandwich four magazines on train night usually even read one dumb stories magazine without puking know stories lot phony guys named lot phony girls named always lighting goddam 	like_trains night lights_on black_windows coffee magazines_read ham_sandwich puking phony 
pipes even read one lousy stories train night usually time different feel like sort sat anything take hunting hat put pocket 	pipes lousy_stories train_night different_time sat hunting_hat 
sudden lady got sat next whole car empty pretty late sat next instead empty seat big bag sitting front seat stuck bag right middle aisle conductor everybody could trip 	lady sat_next empty_car late big_bag front_seat 
She orchids like big party something She around forty guess good looking Women kill really mean oversexed anything like quite sexy like them mean always leaving goddam bags middle aisle 	orchids big_party She_around_forty good_looking Women_kill oversexed like_them 
sitting sudden said Pencey Prep sticker looking suitcases rack said right goddam Pencey sticker one corny admit 	there Pencey_Prep_sticker suitcases_rack corny 
go said nice voice nice telephone voice mostly carried goddam telephone around said lovely know son goes 	nice_voice telephone_voice lovely 
class son doubtless biggest bastard ever went whole crumby history school always going corridor shower snapping soggy old wet towel asses exactly kind guy 	son biggest_bastard whole_history corridor shower snapping_asses 
nice lady said not corny nice must tell met said ask name dear told feel like giving whole life history name janitor dorm 	not_corny lady_said met ask_name life_history janitor 
like asked not bad not paradise anything good schools faculty pretty conscientious adores know said started shooting old crap around little bit adapts well things really mean really knows adapt 	not_paradise schools conscientious adores shooting_crap adapts_well 
think asked sounded interested hell said watched take off gloves lousy with rocks broke nail getting cab said looked sort smiled 	interested take_off_gloves lousy_with_rocks broke_nail cab smiled 
terrifically nice smile really Most people hardly smile lousy one father sometimes worry said sometimes feel terribly good mixer 	nice_smile lousy_smile Most_people father_worry 
mean sensitive boy really never terribly good mixer boys takes things little seriously age killed guy sensitive goddam toilet seat 	sensitive_boy mixer_boys things_seriously sensitive toilet_seat 
gave good look look like dope looked like might pretty damn good idea bastard mother always mother mean slightly insane thing though liked old mother right care cigarette asked 	good_look dope good_idea mother_insane cigarette 
looked around believe smoker said killed right smoke till start screaming us said took cigarette gave light 	smoker killed screaming gave_light 
looked nice smoking inhaled wolf smoke way women around age lot charm quite lot sex appeal really want know 	nice_smoking inhaled charm sex_appeal age 
looking sort funny may wrong believe nose bleeding dear said sudden nodded took handkerchief got hit snowball said icy ones probably told really happened taken long 	funny bleeding_nose nodded handkerchief snowball_hit really_happened 
liked her though beginning feel sort sorry told her name said one popular boys know 	liked_her sorry popular_boys 
nodded really took everybody quite long time get know him funny guy strange guy lots mean first met him first met him thought kind snobbish person thought got original personality takes little get know him 	nodded funny_guy strange_guy first_met_him snobbish_person original_personality 
say anything boy seen glued seat take mother want hear hot-shot son really started chucking old crap around tell elections asked class elections 	glued_seat mother hot-shot_son old_crap class_elections 
shook her head her trance like really bunch us wanted old president class mean unanimous choice mean boy could really handle job chucking elected 	trance_her class_president unanimous_choice chucking 
reason elected simple obvious reason let us nominate darn shy modest refused really shy oughta make try get looked tell 	obvious_reason shy_modest refused 
amount information one must obtain store order track ever-changing relationships dozen individuals staggering band fifty individuals 1 225 one-on-one relationships countless complex social combinations apes show keen interest social information trouble gossiping effectively archaic sapiens probably also hard time talking behind backs much maligned ability fact essential cooperation large numbers 	amount_information_staggering ever-changing_relationships fifty_individuals 1_225 one-on-one_relationships keen_interest apes_social gossiping essential 
new linguistic skills modern acquired seventy millennia ago enabled gossip hours end information could be trusted meant small bands could expand larger bands could develop tighter sophisticated types cooperation 1 	linguistic_skills Sapiens gossip be_trusted bands_expand tighter_cooperation 
gossip theory might sound like joke numerous studies support today vast majority human communication whether form emails phone calls newspaper columns gossip comes naturally us seems language evolved purpose think history professors chat reasons meet lunch nuclear physicists spend coffee breaks scientific conferences talking quarks 	gossip studies communication language purpose professors_chat coffee_breaks 
often gossip professor caught husband cheating quarrel head department dean rumours colleague used research funds buy Lexus usually focuses wrongdoings original fourth estate journalists inform society thus protect cheats freeloaders 	gossip husband_cheating quarrel_dean rumours colleague_funds buy_Lexus wrongdoings journalists protect 
likely gossip theory theory valid truly unique feature language not ability transmit information men lions ability transmit information things not exist far know talk entire kinds entities never seen touched smelled 	gossip there-is-a-lion-near-the-river transmit_information things_not_exist Sapiens never_seen touched smelled 
myths gods religions appeared first time animals human species could previously say lion sapiens acquired ability say lion guardian spirit tribe ability speak fictions unique feature language 	myths gods religions Cognitive Revolution lion guardian_spirit tribe fictions 
relatively easy agree sapiens speak things don’t really exist believe six impossible things breakfast could never convince monkey give banana promising limitless bananas after death monkey heaven important fiction dangerously misleading distracting 	don’t_exist sapiens speak believe monkey_give_banana promising limitless_bananas after_death heaven 
go forest looking fairies unicorns would seem less chance of survival people go looking mushrooms deer spend hours praying guardian spirits wasting precious time time better spent foraging fighting fornicating 	forest fairies_unicorns chance_of_survival mushrooms hours_praying wasting_time foraging fighting fornicating 
fiction enabled us merely imagine things collectively weave common myths biblical creation story myths nationalist myths modern states myths give unprecedented ability cooperate flexibly large numbers Ants bees also work together huge numbers rigid manner close relatives 	fiction imagine_things collectively weave biblical_creation nationalist_myths cooperate Ants_bees rigid 
chimpanzees cooperate far flexibly ants small numbers individuals know intimately cooperate extremely flexible ways countless numbers strangers rule world whereas ants eat leftovers chimps locked zoos research laboratories 	chimpanzees_cooperate small_numbers cooperate_flexible strangers Sapiens rule_world ants_eat_leftovers chimps_zoos laboratories 
chimpanzee cousins usually live small troops several dozen individuals form close friendships hunt together fight shoulder shoulder baboons cheetahs enemy chimpanzees social structure tends hierarchical dominant member almost always male termed ‘alpha males females exhibit submission alpha male bowing making grunting sounds unlike human subjects kowtowing king 	chimpanzee small_troops friendships hunt_fight hierarchical_social_structure dominant_male_‘alpha submission bowing grunting 
alpha male strives maintain social harmony within troop two individuals fight intervene stop violence benevolently might monopolise particularly coveted foods prevent lower-ranking males mating females 	alpha_male social_harmony stop_violence monopolise_foods prevent lower-ranking_males females 
two males contesting alpha position usually forming extensive coalitions supporters male female within group coalition members based intimate daily contact hugging touching kissing grooming mutual favours human politicians election campaigns go around shaking hands kissing babies aspirants top position chimpanzee group spend much time hugging kissing baby chimps 	contesting_alpha supporters hugging_touching grooming_favours politicians election_campaigns shaking_hands kissing_babies 
alpha male usually wins position physically stronger leads large stable coalition coalitions play central part overt struggles alpha position almost day-to-day activities coalition spend time together share food help one another times trouble 	alpha_male leads_coalition day-to-day_activities time_together share_food help trouble 
clear limits size groups formed maintained way order function members group must know intimately chimpanzees never met never fought never engaged mutual grooming know whether trust one another whether would worthwhile help one another ranks higher 	members_know_intimately chimpanzees fought mutual_grooming trust ranks 
natural conditions typical chimpanzee troop consists twenty fifty individuals number chimpanzees troop increases social order destabilises eventually leading rupture formation new troop animals 	fifty_chimpanzee order_destabilises number_increases order_destabilises rupture new_troop 
handful cases zoologists observed groups larger hundred groups seldom cooperate tend compete territory food documented prolonged warfare groups even one case activity one troop systematically slaughtered members neighbouring band 	compete_territory warfare slaughtered 
patterns probably dominated social lives early humans including archaic sapiens like chimps social instincts enabled ancestors form friendships hierarchies hunt fight together like social instincts chimps humans adapted small intimate groups group grew too large social order destabilised band split 	patterns early_humans social_instincts friendships hierarchies hunt_fight_together too_large_groups destabilised 
door lights taxi distance thames ledge channel lone souls bank sound taps treads city asleep dreams pushed helped amelia melted turned fog rolled sweeping passed wandering slowly lost sebastian open red quiet pavement 	
	bank sweeping quiet souls passed red taps slowly pavement ledge helped sebastian ledge rolled open 
arms amelia stopped sebastian wrapped 	arms stopped wrapped 
lips arms fingers kissed spreading dropped away sebastian warmth threaded her 	kissed her warmth spreading lips dropped dropped fingers arms threaded away 
aims reasons way apartment idea songs intensity hair care asked gave smile ran make work surprised looked small many messed into how to you 	asked gave small smile many reasons way into apartment ran idea how to make songs work intensity surprised way looked you 
way pain force opinions music punch lost drumming told wanted understood perfectionistic n't n't you 	understood music understood pain way you lost drumming wanted punch perfectionistic 
amelia smile gave guilty 	guilty smile gave 
way parents months things reason talked grave felt touring fell love saw much you you I in 	way you talked parents grave saw you months touring I fell in love 
hand pocket velvet box bit contain surface times knee slid pulled trying fluttering feeling racing worn handled lowered still holding amelia lip many sebastian 	slid hand pocket pulled velvet box lowered knee hand holding still fluttering feeling racing contain worn handled many surface 
amelia imagine day week month year life marry dawson going want ever lose know second Will you me without you 	Will you marry me imagine going day week month year without you 
amelia arms kissed slipping around neck wrapped him 	kissed him arms slipping around neck 
please tell yes best ever gotten 	tell yes best ever gotten 
tears face streamed nodded happy amelia Happy 	tears Happy streamed face nodded 
course yes Of 	course Of yes 
ring even seen yet 	even seen ring yet 
colfax marry ring sebastian 	marry ring 
tears rivers mist ring box emerald diamonds speechless grinning kissed making face wrapped pulling closer lifted revealing encircled went sebastian lid amelia 	kissed tears making rivers face ring box emerald encircled diamonds 
love eyes match figured get green ring you in in 	love you in green eyes 
finger box head shoulder world ring padding tucking away amelia resting walked going pulled slid stared sebastian mindless lost 	pulled ring padding resting going away tucking finger stared shoulder mindless 
amelia finger voices meet looked running ring drifted charlie muffled staircase 	running finger ring looked 
charlie amelia drawing room swarm impact vision eyes aisle murmurs crowd man suit hand grandparents row throat face entered faces barely made raced locked rippled faced standing squeezed joining went stared crowded familiar center sebastian soft white haired black first dry 	entered crowded drawing room raced eyes center aisle standing white haired man black suit squeezed 
breath hands drew taking sebastian deep amelia 	breath deep drew 
aims things concert madison garden linch pin album hand pain happiness midst stress place fiancé even girlfriend saved helping pulled went lost many long drummer square steady 	many things fiancé even girlfriend drummer saved concert 
hands hold tightened on 	on hold hands tightened 
thing voice face thousands heart everything plan spending rest life looked forward always wanted saw aims becoming everyday hear surrounded my 	looked forward everyday voice always wanted hear face saw my heart 
let eyes reached brushed aside shaking glistening tear laugh 	brushed aside tear 
bash words things pulse veins heart change knew say mean simply put beat never wish good describe sebastian was my 	wish was good words pulse veins beat my heart 
service words feelings hand metal finger man wife lips breath cheers ones background hands face continued felt lost drifting around feel sliding along resting ring spoken stealing away loved blurring pulled still lingering amelia aware sebastian skin weight slid aloud 	felt lost words drifting around feel hand metal sliding along skin 
wife words ears said reaching alone My 	wife My words reaching alone ears 
ballroom laughter friends family natalie danny grandparents mother grandmother renee chatter table writers filled charlie spoke joked beside chatted sat laughing emanated crowded closest low amelia haley poppy listened sebastian amongst loud 	closest friends family laughter joked grandparents chatted listened 
amelia hand took leaned sebastian close 	took hand leaned close 
get tell take asked 	tell take get asked 
taxi changes jones kitchens car sebastian smile smug show tonight hour food everyone charity destinations suspect anything week interview month wedding restaurant left back waiting went announced talk called told got poisoning believes concert also mentioned thinking october uber double london great 	taxi changes restaurant left double kitchens back waiting also mentioned week interview month wedding 
bit spy feel little 	little bit spy 
occasion dressed 	dressed occasion 
amelia lapel ran finger 	ran finger lapel 
spy looking ever seen best 	best looking ever seen 
cheers tables grinned leaned forward kissed drawing surrounding 	grinned leaned forward kissed 
food toasts speeches room came went whirled laughter ringing settled turned sebastian 	came went speeches whirled room settled turned 
asked leaning close ready 	ready asked leaning close 
hand panic seizing gripped 	gripped hand panic seizing 
look couple stands sways want gave sure doubtful boring 	sure want gave doubtful look boring couple 
want couple boring 	want boring couple 
time practice let promise botch annulment mean took get wasted reluctant sigh 	mean wasted time took practice 
inches face leaned kissed lingering sebastian front 	leaned kissed lingering inches front face 
stood hand space center ballroom amelia arms piano danny took guiding settled moved open mic 	stood took hand arms settled piano settled 
crowd hands piano keys voice amelia rhythm arms face words thoughts fell made sing coming started waltzing guiding song filtered silent danny harmonize sebastian romantic strong smile spread 	smile spread face song filtered thoughts crowd fell silent hands made piano keys sing started waltzing romantic rhythm 
song wrote asked quietly 	wrote song asked quietly 
shrug gave sebastian 	gave shrug 
use someone words figured else own 	someone else words use own 
memory scenes relationship laughed describing painting lyric vivid 	laughed lyric describing memory painting scenes relationship 
music dance floor fingers hand amelia spot renee arms ended crowd stepped moved mother reaching closing took vacated linking cheered sebastian graceful 	ended music crowd cheered moved mother reaching fingers graceful hand 
look awe crept eyes mother forms water smile face renee watched dancing moving effortlessly sat lilly stared leaned amelia sebastian proud lips son close Sebastian 	forms moving effortlessly water watched Sebastian dancing 
please tell looked sebastian good 	looked good 
amelia people history astaire dancing right moved fred 	people dancing right people history moved 
murmurs ballroom sebastian towards table mother charlie amelia dance floor rippled walked back collected stepped 	collected stepped dance floor rippled ballroom walked 
charlie voice forth said swayed late low n 	late said voice low 
amelia suspicion eyed 	eyed suspicion 
late 	late 
joint damage car keys half way station lawyer minutes still done slip train annulment written bust minimal stole balcony ten flat 	slip balcony way half train station annulment written lawyer minimal damage stole 
way charlie eyebrows frown edged between 	frown edged between eyebrows 
moment room hair party admit know stepped wearing done want knocked going dress birthday 	moment stepped room wearing dress knocked going 
lips loving played smile 	loving played smile lips 
charlie nothing change love ever 	love nothing change ever 
charlie dimple winked 	dimple winked 
amelia miss love going 	love going miss 
balcony light doors ballroom music summer air bathed leading pouring drifting warm golden 	balcony bathed warm golden light music drifting summer air 
amelia come still cake said 	still cake 
smile towards face frosting eyes gaze hair bangs voices silence hand amelia stepped going leaned cupped kissed met drifted swiped laughter moved settled sebastian mischievous sugary cheek second crumbs fill slid . 	stepped smile going mischievous cupped face kissed sugary frosting cheek laughter moved 
london apartment building bought left um 	left bought apartment building 
thought want got sebastian live married 	thought got married 
charlie want know way bought offended living alone thought far worried 	bought want offended know worried living alone 
cut words lips arms wound waist moment seemed saying pulled lost amelia sebastian forget closer long 	arms wound waist pulled closer 
colfax love ever told absolutely completely sebastian much utterly you 	ever told much absolutely completely utterly love you 
world music voices planet leaned laughter melting away kissing 	kissing planet 
see rationality variety agents environ ment plan book use set design principles applied operating develop concept wide imaginable small 	rationality agents design principles 
building agents systems begin environments observation others idea agent environment reasonably called examining coupling behave leads naturally behaves well depends successful intelligent better rational possible nature difficult 	agents intelligent environments coupling better difficult 
crude categorization environments properties environment influence design agents number skeleton agent designs rest book show give suitable describe basic flesh 	properties environment design agents skeleton 
agents environments environment sensor actuator agent anything sensors actuators idea eyes ears organs hands tract viewed perceiving acting illustrated simple figure human legs vocal SENSOR ACTUATOR 	SENSOR ACTUATOR perceiving acting human eyes ears hands legs 
agent range finders motors actuators software keystrokes file contents network packets inputs environment screen files cameras sensors receives acts displaying writing sending robotic infrared various sensory 	robotic cameras sensors motors actuators software acts displaying 
term percept inputs sequence history everything choice action date anything refer given ever perceived depend specifying said less use agent perceptual instant complete general entire observed possible 	percept inputs history 
sequence section agents agent sensors actions figure interact actuators mown maps action environments percepis function say mathematically speaking given percept hvlollicli actual aoint behavior described Mathematically 	Mathematically behavior agent percept maps action 
imagine function describes agents fact place bound length sequences principle construct actions response course characterization tabulating given percept want consider trying recording agent large table infinite experiment possible external 	table percept recording actions response 
function program ideas description implementation system internally implemented keep running agent artificial important distinct abstract mathematical concrete physical 	agent program physical system 
illustrate ideas example vacuum world figure describe everything variations locations agent perceives dirt use shown happens also made squares square simple cleaner invent many particular b vacuum-cleaner which 	vacuum-cleaner squares perceives which dirt 
move suck dirt nothing simple agent function dirty tabulation figure program implements page left following otherwise shown appears choose right current square partial 	move left right suck dirt 
figure see world agents hand column ways question wiwi way fill words intelligent answer questions section looking defined simply filling makes various vacuum right obvious table agent good bad stupid 	makes agent good bad intelligent stupid answer 
uses randomization actions sequence times probability action chapter intelligent try identify imagine acting randomly rather silly show later agent choose many 	randomization probability silly intelligent 
suck figure tabulation agent function vacuum world closing section notion tool systems characterization agents hand calculator chooses action percept sequence shown emphasize analyzing divides view held displaying given right partial simple cleaner absolute 	agent tool analyzing systems calculator 
analysis calculator sense areas engineering artifacts world ai authors end spectrum resources task environment decision making hardly aid seen designing operates consider requires understanding interact interesting significant computational nontrivial AI 	engineering artifacts interact world AI nontrivial decision making 
behavior concept rationality agent thing entry function mean conceptually speaking filled correctly obviously better good rational right table wrong does 	rational agent right thing does 
section behavior concept rationality performance measure age question way consequences agent environment generates sequence actions percepts receives answer considering plunked according good old 	consequences agent behavior environment actions percepts according 
sequence actions environment states agent desirability performance measure causes go performed well captured evaluates given desirable notion 	actions causes environment states desirability performance measure evaluates 
notice environment states success terms opinion performance rationality agents grapes something g nobel prize said achieve simply deluding _believing really want getting agent define perfect human particular notorious sour e Human 	agent deluding perfect Human sour grapes states 
performance measure agents circumstances sounds example vacuum section amount dirt hour shift course ask get obviously fixed tasks typically designer consider preceding propose cleaned devise appropriate easy cleaner agent single rational vacuum-cleaner eight-hour 	performance measure appropriate circumstances vacuum-cleaner amount dirt eight-hour shift ask get 
agent performance measure dirt floor example point time step penalty electricity maximize cleaning dumping reward awarded perhaps consumed noise generated rational suitable clean square again more 	rational agent maximize cleaning dirt dumping again suitable point clean penalty noise 
rule design performance measures environment agent behave better according actually wants rather thinks general 	rule design performance measures wants environment 
pitfalls issues example notion floor paragraph time agents mediocre job cleans breaks point science fact question implications even avoided remain preceding based yet achieved energetically takes seem far reaching obvious knotty untangle clean average cleanliness different long preferable fine janitorial deep philosophical 	mediocre energetically breaks preferable science philosophical 
life highs humdrum existence economy everyone poverty plenty others questions reader lows lives leave exercise better reckless safe moderate live poor diligent 	better reckless life safe humdrum 
rationality time things performance measure criterion success agent knowledge environment actions sequence date definition given depends defines prior perform leads rational percept four 	rational four performance measure success knowledge actions percept 
sequence agent action ex performance measure evidence knowledge definition pected given provided built possible percept rational select maximize 	percept rational agent action maximize performance evidence knowledge 
chapter intelligent agents vacuum cleans moves figure depends performance measure environment sensors actuators consider square function need say known let assume following simple cleaner agent dirty tabulated rational first ? 	vacuum cleaner rational ? performance known environment sensors actuators 
performance measure point time step steps environment figure dirt distri bution location agent awards lifetime known clean square geography priori initial not 	point clean square geography not location dirt 
squares cleans square actions agent right environment case stay sucking left move take clean current hight outside 	sucking cleans square 
remains actions suck agent location contains claim circumstances mance exercise asks left correctly perceives indeed expected prove available right dirt rational perfor least high Left Left Right Suck 	Left Right Suck location contains dirt rational perfor high 
see agent circum stances example dirt oscillate performance measure penalty point movement fare case nothing easily irrational cleaned needlessly back includes left poorly better squares different forth right sure clean 	agent irrational dirt cleaned oscillate back forth penalty 
squares agent geography environment need explore b exercise asks design agents cases become occasionally check known rather clean dirty needed un stick again re-clean 	dirty again check re-clean environment explore 
omniscience oliniscience rationality omniscient agent outcome actions reality consider example champs day friend street traffic start cross feet door airliner side learning careful knows act accordingly following walking along elysées see otherwise engaged meanwhile falls passing make flattened autonomy distinguish actual impossible old nearby rational cargo of Champs Elysées across 	omniscient knows outcome impossible Champs Elysées street cross airliner falls 
cross street idiot attempts read irrational unlikely obituary ? Idiot 	irrational cross street ? unlikely Idiot 
example shows rationality perfection max imizes performance maximizes question agents point agent action fact design fulfill specification crystal balls time machines expected retreating expect turns actual requirement fair best impossible improve not 	rationality not perfection 
see door latches jets poe behavior concept rationality information exploration definition require omniscience choice sequence date engage activities n urged boeing washington august gathering learning depends also ensure inadvertently allowed decidedly henderson new jumbo good rational percept agent underintelligent not 	rationality not omniscience choice depends percept 
ple agent ways road sequence truck speed definition rationality cross risk accident look crossing percept tell approaching say far first net given ing looking exam busy large high ok rational uninformative great without 	crossing without looking uninformative percept 
agent choose action street performance actions order percepts information gather part rationality chapter example gathering exploration vacuura environment looking stepping helps maximize modify sometimes called ing covered provided undertaken cleaning initially second rational expected future important depth unknown before 	choose looking before stepping order information gathering initially unknown environment 
definition agent gather information perceives configuration knowledge environment gains experience cases priori requires also learn reflect modified completely known need simply acts correctly rational much possible initial sonic prior augmented extreme perceive from 	rational agent gather information learn from perceives gains experience augmented 
course agents beetle fetches heap plug entrance hall route task pantomimes evolution assumption behavior results consider lowly digging laying ball removed continues ging never noticing missing built violated fragile dung nest eggs nearby grasp nonexistent unsuccessful 	agents fragile assumption beetle behavior unsuccessful results 
sphex dig burrow caterpillar drag enter check lay eggs food source hatch entomologist moves step plan modification interventions innate change slightly go sting well serves far inches away continue even dozens moving failing thus intelligent female good revert unable learn not 	female sphex innate plan failing not learn change 
agent relies designer percepts lacks learn incorrect knowl edge example vacuum learns dirt prior knowledge rather say autonomy compensate cleaning foresee appear extent rational autonomous partial additional better autonomous—it 	agent relies prior knowledge lacks autonomy autonomous—it learn compensate foresee 
matter seldom start agent experience designer evolution animals reflexes knowledge ability quires act randomly gave provides enough built survive learn provide well practical complete autonomy little assistance long reasonable artificial intelligent initial no 	agent no experience act randomly designer evolution reflexes learn 
experience environment behavior agent hence incorporation design variety environments become effectively prior knowledge learning allows succeed sufficient rational independent single vast 	experience learning behavior independent rational agent succeed 
chapter intelligent agents nature environments definition rationality rational problems solutions almost think building first however task essen tially autonomy taskenvironment sen ready 	environments problems rational agents solutions 
task environment process number environments variety flavors design agent program_ showing illustrating examples show come flavor directly affects begin specify appropriate 	task environment examples flavors affects design agent 
task environment discussion rationality vacuum specify performance measure actuators sensors group call peas description specifying heading acronymically minded simple cleaner agent Performance Environment Actuators Sensors 	Performance Environment Actuators Sensors description rationality 
agent step task environment designing always specify filly first possible 	designing agent task environment possible 
vacuum world example problem taxi driver point reader capabilities technology page describes robot task let consider automated becomes alarmed fully currently somewhat existing driving extremely ended simple complex full open open-ended 	automated taxi driver open-ended 
agent type performance measure environment actuators sensors trip profits roads traffic customers accelerator horn display cameras speedometer gps odometer accelerometer engine keyboard figure description task taxi driver maximize pedestrians steering brake sonar automated peas safe fast legal comfortable signal Safe 	automated taxi fast comfortable pedestrians customers accelerator horn brake 
performance measure qualities destination fuel con sumption trip time cost violations traffic laws drivers safety passenger comfort maximiz profits goals tradeoffs like automated driver aspire include getting minimizing disturbances maximizing ing obviously conflict required first desirable correct tear 	performance automated driver qualities destination fuel time cost minimizing conflict tradeoffs 
driving environment taxi face driver variety roads lanes alleys lane freeways traffic pedestrians animals road cars puddles deal ranging contain works next rural urban stray police 	environment taxi roads alleys freeways traffic police puddles pedestrians animals 
section nature environments taxi passengers choices california seldom problem alaska potholes also interact need operate snow potential actual optional southern 	taxi passengers snow problem 
drive britain japan environment design problem always driving want enough left obviously restricted right flexible easier Britain Japan 	drive left Britain Japan restricted environment easier design problem 
actuators driver control engine accelerator addition need output voice synthesizer talk passengers way vehicles automated include steering braking display perhaps politely otherwise taxi available human screen communicate 	actuators automated accelerator steering braking passengers communicate 
sensors video cameras road sonar detect dis tances cars obstacles tickets ter la control vehicle accelerometer taxi include see augment avoid speeding properly especially curves basic controllable infrared speedome 	sensors cameras see augment infrared sonar 
state vehicle array engine fuel system sensors drivers positioning gps get microphone passenger request destination need want lost finally keyboard determine mechanical usual electrical many human global GPS 	mechanical state vehicle engine fuel electrical sensors GPS microphone passenger request 
craig mazin man chernobyl miniseries years piece story brain casting props world recreation reality series landmark achievements date eggbaskets version way truth spent making bleedingly built terrifying filmmaking put yet everybody apparently going hbo brilliant sure accurate literal meticulous historical narrative greatest russia focused Chernobyl story world terrifying 1980s Russia less truth 	Chernobyl story world terrifying 1980s Russia less truth 
week moscow times kremlin media outlets show caricature state tv channel planning movie story cia thing reported trashing backed chernobyl actually caused multiple ntv rival less actual uh whole show caricature rival movie CIA 	show caricature rival movie 
muradov director chernobyl movie times story conspiracy americans power plant hand explosion historians day agent enemy intelligence services station russia upcoming told based infiltrated deny said according alexei moscow theory nuclear likely many present conspiracy theory Americans infiltrated explosion agent enemy station day 	conspiracy theory Americans infiltrated explosion agent enemy station day 
course mazin chernobyl thrilling subplot operatives wires switches failed dastardly snipping flipping know actually happen dive whole american Mazin failed dive flipping switches 	Mazin failed dive flipping switches 
place men women everything overcome fallout chernobyl disaster moscow film conspiracy theory officer spies villains tragedy moving sacrificed gives thrilling based struggles tribute heroic detective kgb thwart american new national tribute heroic sacrificed disaster Moscow detective conspiracy American villains 	tribute heroic sacrificed disaster Moscow detective conspiracy American villains 
movie production word jfk style conspiracy theory flick characters accents guys star wars reportedly already exactly get see bizarre least weird british bad movie production conspiracy flick bad guys 	movie production conspiracy flick bad guys 
teenage years school experience institution hierarchy rules memory space security norms environment microcosms prison colonies spent boarding found sheltered says growing made closed arrived elena anosova russian formative universe private social interested female teenage Russian boarding school rules universe private space female prison norms female prison 	teenage Russian boarding school rules universe norms female prison 
russia history prisoners today colonies descendants labor camps type prison territories skill detention long using labour gulag usually combine manufacturing female male free corrective direct become common current former low penal female male prisoners free labour labor camps Russia 	female male prisoners labor camps Russia 
elena anosova access women colonies inmates talks society places prison photographer got photographed saw artist russia patriarchal many Photographer colonies inmates patriarchal society women prison 	Photographer colonies inmates patriarchal society women prison 
vice hey photograph boarding schools switch prisons internet everything places something thing prison elena understand originally set attended anosova well times changed become much needed else decided shoot similar different better next best boarding schools switch prisons 	boarding schools switch prisons 
access places months permission lot people friends parents administration journalist parts get took helped also realised first got still working august access access eight months permission people helped not journalist 	access eight months permission people helped not journalist 
women prison place work villages prisoners people staff men cities care parents families system generations inmates existence landscapes anyone russia look quite often village photographed usually returned take ageing working contrast inside lead cramped yet hardly colony small remote young big outside vast look work small remote villages staff returned care parents cramped 	work small remote villages staff returned care parents cramped 
staff women prisons half head colonies leadership education training service positions work textiles industry places hierarchy lot violence administration prisoners almost including engaged convicts well mainly closed unfortunately always build staff prisons women head engaged leadership education convicts work textiles hierarchy violence 	staff women leadership education convicts work textiles hierarchy violence 
today reports journalists rights activists people prison system basis year deaths dozen according tortured far seen suffocated strangled human russia daily least electrocuted reports tortured Russia prison deaths electrocuted suffocated strangled 	reports tortured Russia prison deaths electrocuted suffocated strangled 
women prison stay photographs weeks get prisoners sister child start project reasons change world way part met received happen enter asked leave take first talk used saw told photographer working think agreed photograph almost purely pretend confessed tea friend honest personal photographed selfish enter prison stay asked leave talk tea friend sister child 	enter prison asked leave talk tea friend sister child 
women prison russia problem violence culture family stuff house time story grandmother daughter husband beat year granddaughter arms woman murder ended discuss go eventually contain anymore killed also broke remember committed pattern serious domestic general appropriate long shocked old pattern ended prison violence family grandmother killed daughter husband 	pattern ended prison violence family grandmother killed daughter husband 
country countryside beat means look point view still remains especially saying love traditional patriarchal visible sad acceptable country traditional patriarchal countryside beat love. sad acceptable 	country traditional patriarchal countryside beat love. acceptable 
women item images things flowers books home bibles decorations everything everyone asked hold sort held cared sent cats favourite lots different individual women favourite item flowers books home bibles cats 	women favourite item flowers books home bibles cats 
types prisons difference women attitudes place time offenders settlement colony prison sentences security recidivists influence visited behaviour colonies different first second repeat third moderate minimum important separate first-time repeat offenders separate influence 	first-time repeat offenders separate influence 
colony repeat offenders hands portraits nothing anything fewer hopes told longer future many empty interested repeat offenders fewer hopes empty hands nothing interested 	repeat offenders fewer hopes empty hands 
learning project infrastructure support people jail lot help face stigma criminals enter system commit crimes job parents series draw attention fact women society information prisons tolerance empathy awareness learned needed released nowhere go labelled forced means find want become need rehabilitated got going lack main russia subsequent burden shot reintegrating great learning infrastructure support released jail labelled criminals. crimes job rehabilitated stigma labelled crimes job burden parents reintegrating society 	support released labelled crimes job burden parents reintegrating society 
prisons women mothers sisters teachers ones grandparents girls feeling left really felt stop loved simply visited many jail cute feeling jail women mothers sisters teachers loved grandparents cute 	feeling jail women mothers sisters teachers loved grandparents cute 
practitioners ads click signals query processing knowledge beings texts applications mind espe search seman filled understand powered get industrial human tic short many ambiguous much little search ads understand short texts ambiguous mind 	search ads understand texts ambiguous mind 
 first bores parents hemorrhages personal touchy father nice 	bores parents hemorrhages personal touchy_father nice 
3 besides going tell whole goddam autobiography madman happened around last christmas got run come take easy mean autobiography madman Christmas run-down take it easy 	autobiography madman Christmas run-down take_it_easy 
4 b brother hollywood far crumby comes visits practically every week end drive home go next month maybe jaguar brother Hollywood crumby place visits week end Jaguar drive home 	brother Hollywood crumby_place visits week_end Jaguar drive_home 
5 one little english jobs hundred miles hour cost damn near four thousand bucks lot dough use used regular writer little English two hundred miles an hour cost dough regular writer 	little_English two_hundred_miles_an_hour cost dough regular_writer 
6 wrote terrific book short stories secret goldfish case never heard best kid let anybody look bought money terrific book short stories Secret Goldfish little kid bought own money goldfish 	terrific_book short_stories Secret_Goldfish little_kid bought_own_money goldfish 
8 want start telling day left pencey prep school agerstown pennsylvania probably seen ads anyway advertise magazines always showing hotshot guy horse jumping fence ever play polo time even saw anywhere left I day Pencey Prep school Pennsylvania ads magazines hotshot guy horse jumping polo 	day_I_left school Pennsylvania magazines hotshot_guy horse_jumping polo 
9 underneath picture says since 1888 molding boys splendid clear thinking young men strictly birds know guys many came way “Since 1888 molding splendid young men birds Strictly clear-thinking two guys 	“Since_1888 molding splendid_young_men Strictly_birds clear-thinking two_guys 
10 saturday football game saxon hall supposed big deal year commit suicide something old win remember three clock afternoon standing top thomsen hill right crazy cannon revolutionary war football game big deal last game didn’t win suicide Hill Thomsen crazy cannon Revolutionary War 	football_game big_deal last_game didn’t_win suicide Thomsen_Hill crazy_cannon Revolutionary_War 
11 could see field teams bashing grandstand hot hear yelling deep side except scrawny faggy visiting team hardly brought people whole field two teams grandstand hot yelling terrific scrawny 	whole_field two_teams hot_grandstand yelling terrific scrawny 
12 girls games seniors allowed bring terrible matter looked somewhere least scratching arms blowing noses giggling never girls football seniors Only terrible school few girls scratching blowing noses arms giggling 	never_girls football Only_seniors terrible_school few_girls scratching_arms blowing_noses giggling 
13 selma thurmer headmaster daughter showed often exactly type drove mad desire girl though sat bus sort struck conversation headmaster’s daughter- drove mad desire nice girl bus struck up conversation 	headmaster’s_daughter- drove_mad desire nice_girl bus struck_up_conversation 
14 liked nose nails bitten bleedy looking falsies point felt sorry give manure great liked big nose bitten nails bleedy-looking falsies felt sorry horse manure great father guy father 	liked big_nose bitten_nails bleedy-looking falsies felt_sorry horse_manure great_guy father 
15 knew phony slob 16 reason instead back new york fencing manager gone morning meet mcburney foils equipment subway phony slob reason standing way up Thomsen Hill fencing team goddam manager big deal New York subway 	phony_slob reason standing_way_up Thomsen_Hill fencing_team goddam_manager big_deal New_York subway 
17 fault keep getting map get thirty dinnertime ostracized train funny wasn’t my fault got back team ostracized train funny 	wasn’t_my_fault got_back team ostracized train funny 
18 say good spencer history teacher grippe figured till vacation started note wanted went coming history teacher grippe Christmas vacation reason wasn’t at the game see again 	history_teacher grippe Christmas_vacation reason wasn’t_at_the_game see_again 
19 forgot kicked account flunking subjects applying gave frequent warning midterms conference kicked me out flunking four subjects warning midterms parents came 	kicked_me_out flunking_four_subjects warning midterms parents_came 
20 ax frequently academic rating really 21 december cold witch teat stupid reversible gloves somebody stolen camel hair coat room fur lined pocket ax good rating December cold witch’s teat top stupid hill no gloves stolen camel’s-hair coat fur-lined 	ax good_rating December_cold witch’s_teat stupid_hill no_gloves stolen camel’s-hair_coat fur-lined 
22 full crooks wealthy families expensive kidding kept freezing ass crooks wealthy families expensive school next to cannon game freezing ass 	crooks wealthy_families expensive_school next_to_cannon game freezing_ass 
23 watching much hanging trying feel kind schools places leaving hate care sad bad goodby leave wasn’t watching game hanging around feel goodby leaving it leave a place 	wasn’t_watching game hanging_around feel_goodby leave_a_place 
24 worse 25 lucky sudden thought helped make suddenly remembered october robert tichener paul campbell chucking front building feel worse lucky hell out helped remembered football nice guys 	feel_worse lucky hell_out helped remembered football nice_guys 
26 dinner dark ball darker stop finally dinner before dark out chucking ball darker 	before_dinner dark_out chucking_ball darker 
27 taught biology mr zambesi stuck head window us dorm ready chance need biology teacher window dorm dinner 	biology_teacher window dorm dinner 
28 soon turned running toward house live campus lived anthony wayne avenue running hill other side campus 	running hill other_side campus 
29 ran main gate waited breath wind truth heavy smoker thing main gate ran waited breath heavy smoker 	main_gate ran waited breath heavy_smoker 
30 made cut another grew six half inches checkups healthy cut it out grew six inches checkups healthy 	cut_it_out grew_six_inches checkups healthy 
31 across route204 icy fell guess road disappearing breath icy hell fell down running disappearing 	breath icy_hell fell_down running disappearing 
32 terrifically sun crossed cold afternoon no sun out disappearing crossed road 	cold afternoon no_sun_out disappearing crossed_road 
33 boy rang doorbell fast frozen ears hurting move fingers c mon said loud almost open door mrs opened maid rang doorbell Spencer’s house frozen hurting ears open the door maid dough 	rang_doorbell Spencer’s_house frozen hurting_ears open_the_door maid dough 
34 holden lovely dear death think glad lovely to see dear frozen to death glad liked me 	lovely_to_see dear frozen_to_death glad liked_me 
35 ask deaf hung closet brushed hand wear crew comb louder coat deaf hung closet crew cut comb louder 	deaf hung_coat closet crew_cut comb louder 
36 fine closed asked away yet asked kicked out grippe 	asked kicked_out grippe 
37 behaving perfect seventy years bang things haif assed course sounds own room seventy years mean it mean bang things 	own_room seventy_years mean_it_mean bang_things 
38 wondered heck still living stooped posture class whenever dropped piece chalk blackboard row pick think old Spencer wondered still living for stooped terrible posture dropped chalk 	think old_Spencer wondered still_living_for stooped terrible_posture dropped_chalk 
39 awful opinion enough figure instance sunday chocolate beat navajo blanket indian yellowstone park awful thought hot chocolate blanket Indian Yellowstone Park 	awful thought hot_chocolate blanket Indian Yellowstone_Park 
40 buying big bang old as hell buying blanket 	big_bang old_as_hell buying_blanket 
41 knocked polite sitting leather chair wrapped yelled caulfield outside nerves sometimes door open knocked polite leather chair wrapped up yelling nerves 	door_open knocked polite leather_chair wrapped_up yelling nerves 
42 minute reading atlantic monthly pills medicine everything smelled vicks drops depressing sick ratty bathrobe born pajamas bathrobes sorry I’d come reading medicine all over smelled Nose Drops Vicks sick people depressing ratty bathrobe 	sorry_I’d_come reading medicine_all_over smelled Vicks_Nose_Drops sick_people depressing ratty_bathrobe 
43 bumpy chests legs beaches white unhairy hello sir thanks written asking bumpy old chests legs Old guys’ beaches white vacation good-by 	bumpy_old_chests Old_guys’_legs beaches white vacation good-by 
44 seat meant bed better send doctor chuckling straightened seat boy grippe madman chuckling straightened himself game 	seat_boy grippe madman_chuckling straightened_himself game 
45 rock serious eh New York got back fencing team bed rock serious as hell leaving 	New_York got_back fencing_team rock_bed serious_as_hell leaving 
46 yes nodding routine nod life elbow nodding routine nice old guy ass elbow 	nodding_routine nice_old_guy ass elbow 
47 dr understand chat office hours oh well little chat office two hours say Life game 	little_chat office two_hours say Life_game 
48 according rules hit ceiling talking play rules nice didn’t hit ceiling talking 	play_rules nice hit_ceiling talking 
49 plays shots admit hotshots nothing Life game rules my ass No hotshots No game parents 	Life_game rules No_hotshots No_game parents 
50 write monday communicated wednesday night news irritated fourth communicated news irritated fourth school 	communicated news irritated fourth_school 
51 shook shake partly lousy vocabulary act age sixteen seventeen thirteen ironical foot gray shook head 52 millions hairs twelve everybody true shake head “Boy lousy vocabulary young sixteen thirteen act like ironical six foot gray hair shake head lousy vocabulary “Boy young act like thirteen six foot gray hair 	shake_head lousy_vocabulary “Boy act_like_thirteen six_foot gray_hair 
gray hairs kid since act like twelve father says 	gray_hairs since_kid act_like_twelve father_says 
53 bored older notice get bored 54 picking pinching thumb disgusting watch bored act my age act older people never notice 	bored act_my_age act_older people_never_notice 
nodding Old Spencer picking nose pinching old thumb in only me room disgusting 	nodding Old_Spencer picking_nose pinching old_thumb_in only_me room disgusting 
55 privilege meeting mother dad weeks ago grand word puke meeting mother dad little with chat grand people nice hate phony puke 	meeting dad_mother little_chat grand_people nice hate phony puke 
56 sharp tack moved false alarm lift lap try chuck missed picked put sharp tack say to me false alarm moved around false alarm chuck it bed missed 	sharp_tack say_to_me moved_around false_alarm chuck_it bed missed 
57 lecture mind idea lectured smell get out feel coming terrific lecture smell Vicks Nose Drops old Spencer pajamas didn’t feel like pajamas 	get_out feel_coming terrific_lecture smell Vicks_Nose_Drops old_Spencer didn’t_feel_like pajamas 
58 tough carry term five failing bit hardest matter boy old Spencer tough carry subjects ”“Five failing in ”“Four bed moved 	matter boy old_Spencer tough carry_subjects failing_in ”“Four bed_moved 
59 passed beowulf lord randal son whooton work compositions English all right compositions 	English all_right compositions 
60 listening listened flunked absolutely help drives wasn’t listening flunked history knew nothing drives crazy 	wasn’t_listening flunked_history knew_nothing drives_crazy 
61 twice times doubt textbook say twice admit first three times opened textbook truth 	say_twice admit_first three_times opened_textbook truth 
62 glanced couple hurt feelings sarcastic ah exam paper chiffonier pile please glanced hurt feelings mad history sarcastic exam paper chiffonier pile 	glanced hurt_feelings mad_history sarcastic exam_paper chiffonier pile 
63 dirty trick alternative cement imagine stopped dirty trick alternative cement bed sorry stopped by good-by 	dirty_trick alternative cement_bed sorry stopped_by good-by 
64 handling turd studied egyptians november 4th 2nd chose optional essay question exam paper turd Egyptians studied hear 	exam_paper turd studied_Egyptians hear 
65 read ancient race caucasians residing northern sections africa latter largest continent eastern hemisphere stop teacher Egyptians ancient race Caucasians northern Africa largest continent 	stop_teacher Egyptians ancient_race Caucasians northern_Africa largest_continent 
66 sit listen crap certainly extremely interesting today various reasons modern science ingredients dead faces rot innumerable centuries riddle challenge twentieth century listen crap dirty trick interesting Egyptians science secret ingredients dead people not rot centuries riddle 	listen_crap dirty_trick interesting_Egyptians science secret_ingredients dead_people not_rot centuries riddle 
67 beginning shall ends voice however bottom page paper down stopped reading hate sarcastic voice dropped note 	paper_down stopped_reading hate sarcastic_voice dropped_note 
68 firecracker stop out loud reading hot firecracker Egyptians 	stop out_loud reading hot_firecracker Egyptians 
69 seem interested although lectures flunk else respectfully interested flunk me except English Respectfully 	interested flunk_me except_English Respectfully 
70 beaten ping pong forgive paper down beaten hell out ping-pong don’t forgive reading crap loud out damn note wouldn’t feel too bad 	paper_down beaten_hell_out ping-pong don’t_forgive reading_crap out_loud damn_note feel_too_bad 
71 blame wished calling tried naturally boring minutes blame flunking chucking missed boring pick it up 	blame flunking chucking missed boring pick_it_up 
72 done shot bull real moron my place truth boy felt lousy flunking moron 	my_place truth_boy felt_lousy flunking moron 
73 appreciate same thing tough teacher bull old bull 	same_thing tough_teacher old_bull 
74 lagoon central south wondering ducks shot the bull New York lagoon Central Park wondering frozen where ducks go 	shot_the_bull New_York lagoon Central_Park wondering frozen where ducks_go 
75 truck took zoo flew ducks went icy lagoon guy truck zoo flew away 	ducks_went icy_lagoon guy_truck zoo flew_away 
76 shoot hard talk interrupted shooting interrupting lucky shoot old bull old Spencer think ducks funny don’t think hard talk teacher sudden interrupted 	lucky shoot_old_bull old_Spencer think_ducks funny don’t_think_hard talk_teacher sudden_interrupted 
77 cover chest beautiful view feel about 78 mistaken believe difficulty elkton hills nasty quit feel flunking cover up bumpy chest beautiful view 	feel flunking cover_up bumpy_chest beautiful_view 
mistaken difficulty School not nasty Hills quit 	difficulty_School not_mistaken nasty quit 
79 may long story complicated understood alley biggest surrounded phonies long story complicated phonies biggest reasons left phonies 	long_story complicated biggest_reasons left phonies 
80 haas phoniest bastard met ten sundays shaking hands charming headmaster phoniest bastard charming as hell parents shaking hands 	headmaster phoniest_bastard charming_as_hell parents shaking_hands 
81 roommate fat corny suits shoulders black andwhite shoes hans smile funny-looking parents fat mother father suits big shoulders phony smile 	funny-looking_parents fat_mother father_suits big_shoulders phony_smile 
82 stand makes depressed hated 83 particular qualms sure takes can’t stand drives crazy depressed go crazy qualms leaving hit me thinking 	depressed go_crazy qualms leaving hit_me thinking 
84 concern future going home 	going home 
85 late hearing sound sense going home moron no concern future boy 	going_home moron no_concern future_boy 
too late dead depressing sense head help 	too_late dead depressing sense_head help 
86 opposite sides ot pole save opposite sides “Thanks appreciate got up bed save life 	opposite_sides “Thanks appreciate got_up bed save_life 
87 gym face gym equipment get going take home nodding serious look sorry for him felt sorry sudden 	gym_equipment get_going take_home nodding serious_look felt_sorry 
88 hang longer missing chucked grippy hang around missing the bed opposite sides sad old bathrobe chest showing grippy smell 	hang_around missing_the_bed opposite_sides sad_old bathrobe chest_showing grippy_smell 
89 worry phase goes phases Don’t worry phase all right 	Don’t_worry phase all_right 
90 answers shoulder okay don’t worry hate answers 	don’t_worry hate_answers 
91 cup hot chocolate get going gym 	hot_chocolate get_going gym 
92 drop line shut luck shook hands sad feel drop line Take care ”“Good-by boy the shut door yelled “Good 	shook_hands feel_sad drop_line Take_care ”“Good-by boy shut_door yelled 
93 hope yell liar store buy magazine asks liable opera yell “Good luck sounds terrible TERRIFIC LIAR awful store asks going opera 	yell “Good_luck sounds_terrible TERRIFIC_LIAR store asks opera 
94 sheer lie sheer lie gym equipment 	sheer_lie gym_equipment 
95 ossenburger memorial wing dorms juniors junior senior named pot undertaking business parlors country members family buried new dorms junior roommate senior dough undertaking family buried five bucks 	new_dorms junior roommate senior dough undertaking family_buried five_bucks 
96 shoves sack dumps river alter cadillac locomotive cheer sack dumps river pile of dough big Cadillac football all stand up cheer 	sack dumps_river pile_of_dough big_Cadillac football all_stand_up cheer 
97 chapel speech lasted fifty jokes show ashamed trouble knees pray god speech ten hours chapel fifty corny jokes regular guy big deal never ashamed trouble down knees 98 wherever ought jesus buddy talked driving car killed shifting gear stiffs speech ten hours corny jokes regular guy big deal trouble down knees pray God 	speech ten_hours corny_jokes regular_guy big_deal trouble down_knees pray_God 
pray Jesus buddy driving car big phony bastard first gear asking Jesus 	pray Jesus_buddy driving_car big_phony_bastard first_gear asking_Jesus 
99 part middle swell edgar marsalla laid fart crude amusing good speech swell guy hot-shot sudden fart crude thing amusing 	good_speech swell_guy hot-shot sudden_fart crude_thing amusing 
100 blew roof laughed rostrum sore compulsory study blew off roof sore 101 created disturbance fit rip making mood blew the roof off laughed rostrum sore compulsory study speech 	blew_roof_off laughed rostrum sore compulsory_study speech 
boy disturbance wasn’t fit right mood another one right mood new dorms 	boy_disturbance wasn’t_fit another_one right_mood new_dorms 
102 heat change cosy tie unbuttoned shirt collar hat back nice room heat on cosy coat off tie off unbuttoned collar; 	nice_room heat_on cosy coat_off tie_off unbuttoned_collar; 
103 red hunting peaks sports noticed lost buck wore swung peak red hunting hat sports store window subway out of cost a buck liked it 	red_hunting_hat sports_store window out_of_subway cost_a_buck liked_it 
104 chairs ward stradlater shape comfortable looked good book sat chair arms sad shape comfortable 	looked_good book sat_chair arms_sad_shape comfortable 
105 library mistake wrong isak dinesen stink book mistake wrong book stink 	mistake_book wrong_book stink 
106 illiterate favorite author ring lardner birthday good book illiterate read a lot favorite brother book birthday 	good_book illiterate read_lot favorite_brother book_birthday 
107 traffic cop falls love cute speeding married marry crazy plays traffic cop falls love cute girl speeding married cop 	crazy_plays traffic_cop love cute_girl_speeding married_cop 
108 gets classical books return native mysteries knock girl killed funny book classical books war books mysteries knock out 	girl_killed funny_book classical_books war_books mysteries knock_out 
109 knocks wish friend call phone happen knocks me out wish terrific friend author call him up doesn’t happen 	knocks_me_out wish terrific_friend author call_him_up doesn’t_happen 
110 human bondage somerset maugham summer except dead calling 111 rather thomas hardy eustacia vye calling Isak Dinesen up except dead 	calling_up Isak_Dinesen except_dead 
112 already certain parts pages shower curtains without ackley roomed rooms eighty barged put on hat reading book read over again three pages shower coming barged somebody shower coming barged 	put_on_hat reading_book read_over_again three_pages somebody_coming shower barged 
 114 one tall round shouldered guys six four lousy teeth whole time roomed next never even saw brush always looked mossy awful damn near made sick dining room mouth full mashed potatoes peas something besides lot pimples 113 probably guy dorm game hardly ever went anywhere peculiar senior pencey years nobody called except ackley herb gale roommate bob ack gets married wife call only guy whole dorm game peculiar guy senior 	only_guy whole_dorm game peculiar_guy senior 
 114 one tall round shouldered guys six four lousy teeth whole time roomed next never even saw brush always looked mossy awful damn near made sick dining room mouth full mashed potatoes peas something besides lot pimples 113 probably guy dorm game hardly ever went anywhere peculiar senior pencey years nobody called except ackley herb gale roommate bob ack gets married wife call only guy whole dorm game peculiar guy senior very tall lousy teeth round-shouldered never brush tall teeth mossy mouth full mashed potatoes pimples 	lousy_teeth never_brush_teeth tall_round-shouldered mouth_full mashed_potatoes pimples 
115 forehead chin face terrible personality sort nasty crazy tell truth nasty guy terrible personality 	nasty_guy terrible_personality 
116 could feel standing shower ledge right behind chair taking look see stradlater around hated guts came everybody 117 hi said terrifically bored tired want think visiting wanted come mistake god sake bored “Hi come in by mistake 	bored_“Hi come_in_by_mistake 
118 book goner anyway quick away goner didn’t look up book 	goner didn’t_look_up book 
119 started walking slow way picking desk chiffonier picked boy get nerves sometimes fencing quit reading enjoying give win walking slow room picking up stuff personal get on nerves fencing win 	walking_slow room picking_up personal_stuff get_on_nerves fencing win 
120 without looking though say everything twice sneaked fiddling picture girl used go new york sally hayes “Nobody won say twice fiddling girl picture 	“Nobody_won say_twice fiddling girl_picture 
121 must goddam least five thousand times since got put back wrong finished purpose picked up picture put back wrong place on purpose 	picked_up_picture put_back wrong_place on_purpose 
122 left foils subway still chrissake ya lost mean keep getting map wall foils subway lost wrong subway look map 	foils_subway lost wrong_subway look_map 
123 stood light hey read sentence twenty anybody else taken hint make pay em read sentence twenty times taken hint Not him 	read_sentence twenty_times hint_taken Not_him 
124 know bout sitting kid telling sixteen eighteen drove mad give damn sitting down Ackley kid light drove mad 	give_damn sitting_down Ackley_kid light drove_mad 
125 kept exactly kind asked finally took longer hellya kept standing asked wouldn’t 	kept_standing asked wouldn’t 
126 shoved hand name good terrific sarcastic mood floor impossible shoved book name terrific sentence personal picking up personal stuff book down 	shoved_book name terrific_sentence picking_up personal_stuff book_down 
127 slid watched old making home feeling trip yawning horsing little bit horse slid tired trip New York yawning horsing around 	tired New_York_trip yawning horsing_around 
128 pulled peak hunting hat front eyes thing going blind hoarse voice mother darling dark hunting hat peak front over eyes going blind hoarse voice dark 	hunting_hat peak_front over_eyes going_blind hoarse_voice dark 
129 nuts swear grow groping naturally “You’re nuts give hand grow up blind guy horsing around 	“You’re_nuts give_hand grow_up blind_guy horsing_around 
130 gives bang annoyed brought sadist sadistic often relaxed annoyed hell old sadist brought out quit 	annoyed_hell old_sadist brought_out quit 
131 belongsa holding knee supporter show pick jock strap chucked bed pick up knee supporter jock strap 	pick_up knee_supporter jock_strap 
132 sat arm hellja much buck robbed cleaning fingernails end match funny ears dirty sat down arm chair arm cleaning fingernails started dirty ears mossy-looking teeth 	sat_down arm_chair cleaning_fingernails dirty_ears mossy-looking_teeth 
133 guess thought neat another wear shoot deer shooting neat guy look hat deer shooting hat 	neat_guy look_hat deer_shooting_hat 
134 closed eye aim people folks kicked yet one eye closed aim people shooting hat folks know kicked out 	one_eye_closed people_shooting_hat folks_know kicked_out 
135 nope date yawned hot sleepy either froze death died heat got date yawned hot room sleepy froze to death died of heat 	got_date yawned hot_room sleepy froze_to_death died_of_heat 
136 great lend scissors willya handy packed already top closet hangnail cut 137 care nearly killed opened door tennis racket wooden press fell head big clunk hurt scissors packed hangnail cut off 	scissors packed hangnail cut_off 
nearly killed clunk head tennis wooden racket-in wooden all-fell head hurt hell packed top closet 	nearly_killed clunk_head racket-in_wooden all-fell_head hurt_hell packed_top_closet 
138 laughing high falsetto suitcase hit rock tickled pants near killed laughing falsetto voice suitcase scissors guy hit head 	near_killed laughing falsetto_voice suitcase scissors guy_hit_head 
139 sense humor handed lemme manager radio cutting horny nails using table sense of humor handed scissors manager radio sat chair horny-looking nails 	sense_of_humor handed_scissors manager radio sat_chair horny-looking_nails 
140 crumby bare feet tonight manners table crumby nails bare feet lousy manners 	table crumby_nails bare_feet lousy_manners 
141 keeping tabs dating reason stand sonuvabitch really thinks prince keeps keeping tabs dating hated Stradlater’s crazy about you prince horsing around bored 	keeping_tabs dating hated_Stradlater’s crazy_about_you prince horsing_around bored 
142 superior attitude mind fifty intelligent superior attitude cutting nails table hey intelligent 	superior_attitude cutting_nails table hey intelligent 
143 please change yelled sore brushing crumby nails cutting nails over table yelled sore brushing teeth 	crumby_nails cutting_nails over_table yelled sore brushing_teeth 
144 insult cryin loud insulting meant better brushed insult cryin’ look better feel better brushed teeth cryin’ 	insult look_better feel_better brushed_teeth cryin’ 
145 gimme seen felt sorry somebody tells bad thats trouble brush teeth seen you don’t you nasty felt sorry isn’t nice don’t know him trouble 	brush_teeth seen_you you_don’t nasty felt_sorry isn’t_nice don’t_know_him trouble 
146 conceited generous things suppose instance wearing tie liked helluva giving example sonuvabitch conceited generous tie liked 	conceited generous tie liked 
147 take ta leave take it off give leave on bed 	take_it_off give leave_on_bed 
148 dough shook biggest stop calling enough dough shook head old biggest-““Stop kid old enough lousy father 	dough shook_head kid old father 
149 aggravating missed chance let family well aggravating never missed not let you my in family cut out calling 	aggravating not_let_you_in family cut_out calling 
150 sudden barged hurry deal gave playful slaps cheeks annoying listen anywheres special door opened barged in big hurry big deal playful slaps cheeks-which annoying going out tonight 	door_opened barged_in big_hurry big_deal playful_slaps annoying going_out tonight 
151 might snowing snow coat yeah anyplace lending hound tooth jacket half leaving kidding gonna use spilled crap gray flannel snow coat not special anyplace jacket game half spilled crap gray flannel 	snow_coat not_anyplace_special jacket game_half spilled_crap gray_flannel 
152 stretching shoulders practically heighth weighed broad stretch stretching shoulders 153 sa friendly partly phony hello stretching broad shoulders stretch it closet big hurry 	broad_shoulders stretch_it closet big_hurry 
friendly guy phony friendly hello 	friendly_guy phony_friendly hello 
154 grunted answer grunt later okay broke heart grunted wouldn’t answer guts enough broke heart went back room 	grunted wouldn’t_answer guts_enough broke_heart went_back room 
155 maybe fast shave heavy beard waiting annex toilet kit towel taking off coat fast shave heavy beard date toilet kit towel 	taking_off_coat fast_shave heavy_beard date toilet_kit towel 
156 shirt walked torso build admit No shirt bare torso 	No_shirt bare_torso 
157 chewed rag shaving ones windows steamy ten washbowls middle turning cold water nervous habit chewed rag shaving only ones game as hot hell all steamy windows water on water nervous habit 	chewed_rag shaving only_ones game hot_as_hell steamy_windows water_on nervous_habit 
158 whistling song india shaved piercing whistles tune hard whistle whistler slaughter tenth avenue mess whistling shaved mess up song 	whistling shaved mess_up_song 
159 remember slob habits different secret razor rusty lather hairs slob secret rusty razor looked all right 	slob secret rusty razor looked_all_right 
160 cleaned fixing knew fixed madly love handsomest western hemisphere never cleaned looked good secret slob madly in love handsomest guy He thought 	never_cleaned looked_good secret_slob madly_in_love handsomest_guy He_thought 
161 handsome mostly year handsomer pictures handsome pictures 	handsome pictures 
162 noses stuck experience frequently 163 washbowl red big noses ears stuck out water on off water red hunting hat peak back bang hat 	big_noses ears_stuck_out water_on water_off red_hunting_hat peak_back bang_hat 
164 wanna favor enthusiastic asking real shot themseif dying big favor Not enthusiastic handsome guy crazy about themseif dying to funny 	big_favor Not_enthusiastic handsome_guy crazy_about_themseif dying_to funny 
165 goin hundred pages history monday writing composition english creek ask out tonight read history writing composition up creek 	out_tonight read_history writing_composition up_creek 
166 ironical flunking write buddy buddyroo ironical flunking out write composition up creek buddy 	ironical flunking_out write_composition up_creek buddy 
167 suspense bastards descriptive house lived long yawn royal pain ass Suspense bastards room house descriptive as hell big yawn royal pain 	Suspense bastards room house descriptive_as_hell big_yawn royal_pain 
168 yawns hartzell knows stick commas yawns favor hot-shot roommate stick commas 	yawns favor hot-shot roommate stick_commas 
169 compositions starts talking royal pain writing compositions commas lousy writing stuck wrong place 	royal_pain writing_compositions lousy_writing stuck_commas wrong_place 
170 basketball team howie coyle sink touching backboard perfect hate basketball game game terrific guy team perfect build hate 	basketball_game terrific_guy team perfect_build hate 
171 backed tap dance amusing stone dancing bored tap dance amusing myself stone floor 	bored tap_dance amusing_myself stone_floor 
172 imitating movies musicals poison mirror need audience exhibitionist goddarn governor son imitating movies guys hate movies poison bang get mirror audience 	imitating movies_guys hate_movies poison get_bang mirror audience 
173 knocking dancer wants oxford blood laughed opening night ziegfeld follies Tap-dancing Oxford tap dancer Oxford in my blood laughed 	tap_dancer Oxford in_my_blood laughed 
174 breath wind leading man drunk bastard ole out of breath leading man drunk 	out_of_breath leading_man drunk 
175 dja ninetieth morning hat hunting out breath of quit horsing New York a buck 	hat hunting out_of_breath quit_horsing New_York a_buck 
176 nodded sharp flattering fitzgerald nodded “Sharp flattering write composition time your date 	nodded “Sharp flattering write_composition time your_date 
177 pig catcher rye type jumping nelson pig Catcher too old Stradlater half nelson 	pig Catcher too_old half_nelson 
178 wrestling hold case neck choke landed panther wrestling hold neck choke to death landed panther 	wrestling_hold neck choke_to_death landed panther 
179 holden wuddaya liberate viselike grip horsing around shaving half nelson “Liberate viselike grip 	horsing_around shaving half_nelson “Liberate viselike_grip 
180 je sus christ jerked arms strong weak gorgeous razor jerked arms down strong guy weak guy shaving shaved twice gorgeous look crumby razor 181 phyllis smith babe supposed arrangements screwed bud thaw almost forgot strong guy weak guy shaved twice look gorgeous crumby razor 	strong_guy weak_guy shaved twice look_gorgeous crumby_razor 
your date asked babe screwed up 	your_date asked babe screwed_up 
182 interested thinking uh jean gallagher dropped dead jane pretty interested “My date dropped dead Jean got up 	pretty_interested “My_date dropped_dead got_up 
183 summer last doberman pinscher met dog coming know her next door summer met dog 	know_her next_door summer met dog 
184 excited oughta excited say hello 	excited say_hello 
185 happen mention b shipley excited mention 	excited mention 
186 lift stupid jesus h putting vitalis hair towel sitting on hair 	towel sitting_on hair 
187 ballet practice hours every day hottest weather worried legs thick play checkers dancer two hours hottest weather legs thick checkers her 	dancer two_hours hottest_weather thick_legs checkers_her 
188 move kings king row lined move ”“Checkers move kings back row 	”“Checkers move_kings back_row 
189 interest belonged club caddy couple seventy nine holes mother club caddy dough make 	mother_club caddy make_dough 
190 listening combing locks tcha minute parting hour comb hardly listening say hello an hour comb hair 	hardly_listening say_hello an_hour comb_hair 
191 divorced booze skinny hairy wore shorts playwright single mystery program run naked divorced mother married booze hound “Skinny guy hairy legs playwright booze mystery program run naked 	mother_married booze_hound “Skinny_guy hairy_legs playwright booze mystery_program run_naked 
192 running sexy childhood interested booze hound running naked sexy lousy childhood stuff 	interested booze_hound running_naked sexy_stuff lousy_childhood 
193 instead window off my mind say hello steamy window not mood 	off_my_mind say_hello steamy_window not_mood 
194 sworn enjoy be in mood enjoy game 	be_in_mood enjoy game 
195 articles play checkers met her gorgeous hair crumby toilet articles 	play_checkers met_her gorgeous_hair crumby_toilet_articles 
196 regards regards room can thinking about Jane 	regards room can thinking_about_Jane 
197 spent life tie mirror half life sat chair 	tie mirror half_life sat_chair 
198 explain nosy kicked out wasn’t interested nosy 	kicked_out wasn’t_interested nosy 
199 try worn cigarettes muffler pocket jacket put on not stretch it cigarettes your muffler coat pocket 	put_on_jacket not_stretch_it cigarettes muffler coat_pocket 
200 hat peak front nervous getting where date 	hat_peak_front getting_nervous where_date 
201 signed thirty charming known New York handsome charming nine-thirty 	New_York handsome charming nine-thirty 
202 rile easily ready knock rile conceited coat on descriptive as hell composition 	rile conceited coat_on descriptive_as_hell composition 
203 easy banged didn’t answer kings back row out of room 	didn’t_answer kings back_row out_of_room 
204 half hour thinking about Jane date with her nervous went crazy sexy bastard 	half_hour thinking_about_Jane date_her nervous went_crazy sexy_bastard 
205 curtains usual glad till dinnertime squeezing pimple handkerchief Ackley barged in Ackley barged in shower curtains glad mind off dinnertime hated guys squeezing pimple chin 	barged_in shower_curtains glad mind_off dinnertime hated_guys squeezing_pimple chin 
206 meal saturday nights steak bet bucks school sunday thurmer figured dinner handkerchief same meal big deal steak parents dinner 	handkerchief same_meal big_deal steak parents dinner 
207 steaks dry jobs lumpy dessert brown betty ate kids lower racket steaks hard dry lumpy mashed potatoes Brown Betty nobody ate kids 	racket hard_dry_steaks lumpy_mashed_potatoes Brown_Betty nobody_ate kids 
208 three inches ground madman throwing snowballs childish three inches snow madman throwing snowballs horsing around childish enjoying 	three_inches_snow madman throwing_snowballs horsing_around childish enjoying 
209 friend mine mal brossard decided bus agerstown hamburger movie neither us minded along stay squeeze didn’t have date friend wrestling team bus hamburger lousy movie squeeze pimples 	didn’t_have_date friend wrestling_team bus hamburger lousy_movie squeeze_pimples 
210 idea rooms galoshes hear get ready rooms hear didn’t answer yelled 	get_ready rooms hear didn’t_answer yelled 
211 hates shipwrecked somewhere rescued boat rowing shipwrecked rescued boat who the guy 	shipwrecked rescued boat who_the_guy 
212 wait 213 snowball hands packing throw big favor five hours get ready window snowball bare hands 	big_favor five_hours get_ready window snowball bare_hands 
214 car parked across street changed white hydrant throw At car nice white car hydrant 	throw_At_car nice_white_car hydrant 
215 close walk harder brossnad close window packing snowball walk room bus 	close_window packing_snowball walk_room bus 
216 driver doors chuck believe driver opened doors throw it People never believe 	driver opened_doors throw_it People_never_believe 
217 playing hamburgers played pinball machine seeing comedy cary grant seen picture playing hamburgers pinball played bus comedy 	seen picture_playing hamburgers played_pinball bus comedy 
218 hyenas hyenas laughed movies wasn’t funny didn’t enjoy 	hyenas_laughed movies wasn’t_funny didn’t_enjoy 
219 quarter bridge fiend laid pillow quarter to nine dorm game room parked bed face on pillow 	quarter_to_nine dorm game room_parked bed face_on_pillow 
220 monotonous hints rid sexual intercourse monotonous voice picking pimples thousand hints keep talking babe sexual intercourse summer 	monotonous_voice picking_pimples thousand_hints keep_talking babe sexual_intercourse summer 
221 cousin buick boardwalk virgin doubt clear concentrate boardwalk 222 pajamas bathrobe time pajamas bathrobe hunting hat writing composition 	time pajamas_bathrobe hunting_hat writing_composition 
 54 one common uses early stone tools crack open bones order get marrow researchers believe original niche woodpeckers specialise extracting insects trunks trees first humans specialised well suppose observe pride lions take devour giraffe 53 thus lived million years ago despite big brains sharp dwelt constant fear predators rarely hunted large game subsisted mainly gathering plants scooping stalking small animals eating carrion left behind powerful carnivores whatever species would neanderthals able serve roman legions sprawling bureaucracy china american declaration independence hold self evident truth members genus homo created equal karl marx urged workers unite 96 past 10 000 sapiens grown accustomed human hard us conceive possibility lack brothers sisters makes easier imagine epitome 95 whichever way happened pose history great ifs things might turned denisovans survived alongside kind cultures societies political structures emerged world several different coexisted example religious faiths unfolded book genesis declared descend adam eve jesus died sins qur seats heaven righteous 109 appearance new ways thinking communicating 70 30 constitutes cognitive revolution caused sure commonly believed theory argues accidental genetic mutations changed inner wiring enabling think unprecedented communicate using altogether type language call tree knowledge mutation 108 explain everything know adventures alice wonderland paradoxes quantum physics could teach people view 107 accomplishments product abilities maintain drove extinction settled australia carved stadel lion man intelligent creative sensitive come across artists cave learn untouched 106 period witnessed invention boats oil lamps bows arrows needles essential sewing warm clothing objects reliably called art date era see page clear evidence religion commerce social stratification 104 conversely time learning understanding 105 beginning started special around bands africa second middle east face earth within remarkably short reached europe asia 45 somehow crossed sea landed continent hitherto 70 000 years ago special things drove human species face earth short period reached Europe East Asia 70 000 years ago witnessed invention boats oil lamps bows arrows needles first art lion-man 	70_000_years_ago witnessed invention boats oil_lamps bows_arrows needles first_art lion-man 
 54 one common uses early stone tools crack open bones order get marrow researchers believe original niche woodpeckers specialise extracting insects trunks trees first humans specialised well suppose observe pride lions take devour giraffe 53 thus lived million years ago despite big brains sharp dwelt constant fear predators rarely hunted large game subsisted mainly gathering plants scooping stalking small animals eating carrion left behind powerful carnivores whatever species would neanderthals able serve roman legions sprawling bureaucracy china american declaration independence hold self evident truth members genus homo created equal karl marx urged workers unite 96 past 10 000 sapiens grown accustomed human hard us conceive possibility lack brothers sisters makes easier imagine epitome 95 whichever way happened pose history great ifs things might turned denisovans survived alongside kind cultures societies political structures emerged world several different coexisted example religious faiths unfolded book genesis declared descend adam eve jesus died sins qur seats heaven righteous 109 appearance new ways thinking communicating 70 30 constitutes cognitive revolution caused sure commonly believed theory argues accidental genetic mutations changed inner wiring enabling think unprecedented communicate using altogether type language call tree knowledge mutation 108 explain everything know adventures alice wonderland paradoxes quantum physics could teach people view 107 accomplishments product abilities maintain drove extinction settled australia carved stadel lion man intelligent creative sensitive come across artists cave learn untouched 106 period witnessed invention boats oil lamps bows arrows needles essential sewing warm clothing objects reliably called art date era see page clear evidence religion commerce social stratification 104 conversely time learning understanding 105 beginning started special around bands africa second middle east face earth within remarkably short reached europe asia 45 somehow crossed sea landed continent hitherto 70 000 years ago special things drove human species face earth short period reached Europe East Asia 70 000 years ago witnessed invention boats oil lamps bows arrows needles first art lion-man revolution cognitive extinction Neanderthals carved Stadel lion-man intelligent creative sensitive artists 	cognitive_revolution extinction_Neanderthals carved Stadel_lion-man intelligent creative sensitive artists 
explain adventures of Alice Wonderland quantum physics teach 	explain adventures_of_Alice_Wonderland quantum_physics teach 
thinking communicating 70 30 000 years ago Cognitive Revolution caused theory genetic mutations brains Sapiens language 	thinking communicating 70_30_000_years_ago Cognitive_Revolution caused theory genetic_mutations Sapiens_brains language 
110 occur dna rather matter pure chance far tell important understand consequences causes enabled conquer Sapiens DNA 111 every animal even bees ants sophisticated informing another whereabouts food neither vocal many including ape monkey languages Sapiens DNA chance consequences Tree of Knowledge mutation special language conquer world 	Sapiens DNA chance consequences Tree_of_Knowledge_mutation special language conquer_world 
animal language insects bees ants communicate 	animal_language insects bees_ants communicate 
112 green monkeys calls various kinds zoologists identified careful eagle slightly warns played group stopped looked upwards green monkeys calls ‘Careful An eagle different ‘Careful lion fear 	green_monkeys ‘Careful_eagle different_calls ‘Careful_lion fear 
113 heard warning quickly scrambled produce distinct sounds whales elephants equally impressive parrot say anything albert einstein mimicking phones ringing doors slamming sirens wailing scrambled tree up distinct sounds whales elephants parrot Albert Einstein mimicking 	scrambled_up_tree distinct_sounds whales elephants parrot Albert_Einstein mimicking 
114 advantage 115 answer amazingly supple connect limited number signs infinite sentences meaning thereby ingest store prodigious amount information surrounding yell comr Einstein advantage over parrot prodigious language sounds signs infinite number information communicate 	Einstein advantage_over parrot language sounds_signs infinite_number communicate_information 
ades modern friends morning near bend river saw tracking herd bison 116 describe exact location paths leading area band put heads together discuss whether ought approach chase away hunt lion modern human river herd of bison location paths leading heads together hunt bison approach 	lion modern_human river herd_of_bison location paths_leading heads_together hunt_bison approach 
117 agrees unique evolved sharing needed conveyed gossiping according primarily theory language evolved sharing information humans not lions gossiping social animal sapiens 	theory language_evolved humans gossiping social_animal sapiens 
118 cooperation key survival reproduction enough individual men women much hates sleeping honest cheat Social cooperation survival reproduction hates sleeping with honest cheat 	Social_cooperation survival reproduction hates sleeping_with honest cheat 
119 4 ivory figurine lioness woman germany c 32 body head leonine indisputable examples probably ability mind really exist ivory figurine ‘lion-man’ Stadel Cave Germany leonine head human body first art religion imagine things 	‘lion-man’ Stadel_Cave Germany leonine_head human_body first_art religion imagine_things 
 224 green ink wrote something read field nobody bat dead got leukemia died maine july 18 1946 liked years younger fifty times intelligent terrifically 223 thing think room house describe way stradlater said crazy describing rooms houses anyway brother allie baseball mitt descriptive subject really left handed fielder though poems written fingers pocket everywhere think room house describing baseball mitt poems written 	think room_house describing baseball_mitt poems_written 
green ink read field leukemia died younger intelligent 	green_ink read_field leukemia_died younger intelligent 
225 teachers always writing letters mother telling pleasure boy class shooting crap meant member family nicest lots ways never mad anybody people red hair supposed get easily teachers letters mother pleasure intelligent family nicest never mad red hair 	teachers letters mother pleasure intelligent_family nicest never_mad red_hair 
226 tell kind started playing golf ten old remember summer around twelve teeing hunch turned sudden see sure enough sitting bike outside fence went course hundred yards behind watching tee red hair ten years old golf hunch turned see Allie bike tee off 	red_hair ten_years_old golf hunch_turned see_Allie bike tee_off 
227 god kid used laugh hard thought dinner table fell chair thirteen going psychoanalyzed broke windows garage blame red hair nice kid laugh hard fell off chair thirteen psychoanalyzed broke windows 	red_hair nice_kid laugh_hard fell_off_chair thirteen psychoanalyzed broke_windows 
228 slept night goddam fist even tried break station wagon hand already broken everything time stupid admit hardly know slept garage broke windows fist station wagon broken hand 	slept_garage broke_windows fist station_wagon broken_hand 
229 still hurts rains make real tight one mean care much surgeon violinist hand hurts rains not surgeon violinist not 	hand_hurts rains not_surgeon not_violinist 
230 composition happened suitcase copied change name else composition wrote baseball mitt suitcase copied poems change name 	wrote_composition baseball_mitt suitcase copied_poems change_name 
231 besides sort took hour use lousy typewriter kept jamming reason lent guy hall lousy typewriter an hour writing lent 	lousy_typewriter an_hour writing lent 
232 thirty guess finished tired looked window snowing every could hear car somewhere able ackley snoring ten-thirty looked window car not started able snoring 	ten-thirty looked_window car_not_able_started snoring 
233 right shower curtains sinus trouble breathe hot asleep pimples teeth halitosis crumby fingernails feel little sorry sonuvabitch shower curtains sinus trouble pimples lousy teeth halitosis crumby fingernails sorry for 	shower_curtains sinus_trouble pimples lousy_teeth halitosis crumby_fingernails sorry_for 
234 6some things thinking back date jane exactly heard footsteps coming corridor probably looking swear damn worried worry fool date footsteps heard corridor worried don’t fool around 	date heard_footsteps corridor worried don’t fool around 
235 go bathroom want interrupt worrying knew double dated bastard couple talking unscrupulous bathroom worry interrupt double-dated unscrupulous 	bathroom_worry interrupt double-dated unscrupulous 
236 linoleum towards came linoleum corridor footsteps sitting window chair 	linoleum_corridor footsteps sitting_window chair 
237 griping cold everybody morgue bother answer realize saturday home week end neck griping cold morgue stupid Saturday night break neck everybody out asleep 	griping_cold morgue stupid Saturday_night break_neck everybody_out asleep 
238 getting undressed say word neither watched thank letting wear hound tooth hung hanger put closet undressed getting didn’t say one word thank wear hanger closet 	getting_undressed didn’t_say_one_word thank wear hanger closet 
239 taking tie asked bed walked unbuttoning shirt stood reading stroking bare chest stomach expression face taking off tie written composition bed unbuttoning bare chest stupid face stroking stomach mad 	taking_off_tie written_composition bed unbuttoning bare_chest stupid_face stroking_stomach mad 
240 chrissake holden glove wuddaya ya baseball glove room house 	baseball_glove room house 
241 difference sore furious backasswards wonder flunking descriptive baseball glove sore furious everything backasswards flunking supposed 	descriptive baseball_glove sore furious flunking supposed 
242 give pulled tore hellja threw pieces wastebasket lay long shorts lit cigarette pulled hand tore it up threw pieces wastebasket lay bed undressed lit cigarette 	pulled_hand tore_it_up threw_pieces wastebasket lay_bed undressed lit_cigarette 
243 allowed smoke dorm late smell annoy drove rules smoked smoke dorm night annoy broke rules 	smoke_dorm night annoy broke_rules 
244 single solitary finally signed nine signing edge cutting toenails coupla minutes signs hated say one word back late cutting toenails hated hated Saturday night 	say_one_word back_late cutting_toenails hated Saturday_night 
245 new york tough listen gonna bout may stick graduate New York crazy tough smoke room hell stick graduate around 	New_York crazy tough smoke_room stick_around graduate 
246 ignored smoking madman turn side cut school somebody squeeze ignored madman smoking turn over watched him cut toenails squeeze pimples school 	ignored madman_smoking turn_over watched_him cut_toenails squeeze_pimples school 
247 regards yeah ask keeps kings row play checkers give regards hell kings back row checkers 	give_regards hell kings_back_row checkers 
248 keep voice shaking nervous feeling gone funny hated didn’t answer hated New York shaking voice nervous funny 	didn’t_answer hated New_York voice_shaking nervous funny 
Bill Gates proclaimed recent graduation ceremony artificial intelligence energy bio science three exciting rewarding career choices young college graduates choose 	Bill_Gates graduation_ceremony artificial_intelligence energy bio_science exciting rewarding career_choices 
agree come believe strongly important questions generation related sustainability energy generation distribution transportation access basic amenities life etc dependent intelligently mix first two branches knowledge mentions 	believe sustainability energy transportation basic_amenities knowledge intelligently_mix 
semiconductor professional years experience top technology company take pride fact work physical electronics directly contributes energy sector develop power semiconductor devices built carry electrical power efficiently reliably power everything tiny sensor inside smartphone large industrial motor drives process food cloth everyday consumption 	experience top_technology_company physical_electronics energy power_semiconductor_devices power tiny_sensor large_industrial_motor 
naturally want learn apply techniques modern data science machine learning improve design reliability operation devices systems no computer science graduate could tell linked list heap vector machines sounded like months special equipment people disabilities keyword remembered junior year elective order predicate remnant approach opposed newer machine learning based approach 	data_science machine_learning improve design reliability operation no_computer_science vector_machines AI 
bad analogy  latest superhero ensemble face time energy limited cannot afford waste precious resources something highly unlikely practice current work future job assuming want take free learning path e auditing rather paying certificates end article would like list think pay showcase certificates 	limited_time_energy waste_resources learning_path MOOCs 
personal journey pay Udemy courses took never free buy cost good lunch sandwich promotion runs picture want show possibilities impossibilities process e hope learn practice must learned job kind mentality must cultivated matter profession said however circles broadly encompass core skills one study 	journey Udemy_courses possibilities mentality profession core_skills 
venture field data science/machine learning background note even information technology sector may steep learning curve ahead traditional disrupted new fields core skills good practices often different one view data science field democratic many professional domains g area work semiconductor tech 	data_science/machine_learning steep_curve data_science democratic 
entry barrier low sufficient hard work zeal anybody acquire meaningful skills personally burning desire field rather passion borrow fruits apply area expertise end goal impact initial learning curve one traverse could aiming either data engineer business analyst machine learning scientist visualization field choices wide open aim like mine 	hard_work zeal acquire_skills passion borrow_fruits traverse_curve choices_wide open 
stay current domain expertise apply newly learned fine started real likelihood cannot go basic this  worked though aversion towards coding simple fun interface right pace free course appropriate excite enough keep going could picked course reading research told optimal choice balancing learning complexity utility 	basic Python Codeacademy aversion_coding fun_interface optimal_choice 
data science) decided trust insight introduction fine base start choices many online MOOC platforms predictably enough signed multiple courses time dabbling class days realized ready enough learn professor looking course taught enthusiastic instructor take time go concepts great detail teach essential tools like notebook system 	data_science) choices MOOC_platforms dabbling_professor detail essential_tools Git Jupyter 
maintain right balance basic concepts advanced topics curriculum found right man job offers multiple courses one popular positively reviewed instructors platform signed completed course amazing introduction language right pace depth rigor recommend course highly new learners even though fork courses generally free regular price 	right_balance curriculum instructors pace depth rigor 
always wait days recurrent promotion cycle sign next step proved crucial could gone astray try study anything everything could class definition part easily suck long arduous journey taking nothing away key sphere universe one safely say practice deep learning good data science without able define class methods 	wait_days recurrent promotion_cycle next_step study_anything arduous_journey deep_learning practice 
fundamental reasons ever increasing popularity de facto language choice data science availability large number libraries classes methods waiting downloaded nice packaged form unwrapped seamless integration code introduced neat little course courses universities rigorous nature short theoretical courses offered technology companies like 	choice_language data_science Python’s libraries high-quality peer-reviewed expert-written neat_course edX 
register many courses program want took following courses intend come back courses courses present material rudimentary fashion cover basics examples enough spark plug hooked last course made realize important things statistics linear algebra core data science process forgot enough 	many_courses rudimentary_fashion spark_plug hooked statistics linear_algebra 
R naturally suited kind work want data sized data generated controlled wafer fab experiment simulation primed basic inferential analysis prompted search solid introductory course R language better turn signed class one get another deal course covered essentials R language first half switched teaching 	sized_wafer R_language essentials teaching 
basic machine learning concepts important concepts expected introductory course covered sufficient course used lab environment course covered installation setup necessary packages introduced kaggle gave required push graduate passive learner video person afraid playing data also followed great book chapter chapter 	machine_learning server-based installation_setup kaggle passive_learner playing_data 
course materials book practice random data sets downloaded kaggle even electricity usage data longer afraid writing small bytes codes actually model something interesting useful analyzed US crime data large lead spurious correlation even electricity usage past 3 months also successfully used built predictive models based data sets work nature language estimate 	Armed data_sets practice kaggle electricity_data US_crime_data spurious predictive_models estimate 
confidence intervals variety models really help new learner gain easy foothold domain statistical modeling aspect learning cannot graduates engineers touch rigorous mathematics years professional lives even wrote medium article mathematics knowledge necessary machine learning data science chose courses stand depth rigor note 	foothold_statistical mathematics_necessary data_science machine_learning 
search sign calculus course comfortable level knowledge could remember college expected useful machine learning data science study practice rusty area please search good one article wrote specifically focused data science article featured prominently editorial choice give 	calculus_comfortable rusty_area article data_science 
among managed complete course considered one pioneers machine learning course guess plenty articles written already therefore waste time describing course take homework programming assignments learn think terms vectorized codes major machine learning algorithms know save notes ready reference future work 	course_pioneers vectorized machine_learning algorithms future_work 
want talk personalities listing various machine learning signed draw closer end long article wanted list two found interesting useful go along specific subject areas mentioned 	personalities listing machine_learning MOOCs subject areas 
usage Big Data grows every facet business analytics engineers mix Big Data Machine Learning skills effectively high demand makes sense focus couple courses centered around mix 	Big_Data business analytics mix Machine_Learning engineers_high_demand courses 
course helps master concepts supervised unsupervised learning recommendation engine time series modeling approach includes working four major projects exercises industry partners advise curriculum 	supervised unsupervised learning recommendation_engine time_series hands-on end-to-end Uber Mercedes-Benz 
Google’s TensorFlow specialization specialization focuses advanced machine learning topics using get experience optimizing deploying scaling production models various types labs 	Google’s_TensorFlow (Coursera) machine_learning optimizing deploying scaling ML labs 
advent programming platforms collaboration tools virtually unlimited free storage learning democratized ubiquitous universally accessible get specialist data learning want learn subject write code higher productivity work strive career enhancement fun time start learning parting comments 	platforms collaboration unlimited_storage ubiquitous_learning specialist data 
Data science analytics machine learning growing astronomical rate companies looking professionals sift goldmine data help drive swift business decisions efficiently predicts 2020 number jobs data professionals increase 364 000 openings 2 720 000 caught Data find makes data science exciting field skills help professionals gain strong foothold domain 	Data_science analytics machine_learning astronomical_companies goldmine drive swift_decisions business exciting 
complete recording read find everything new exciting data science tried define data science decade best way answer question probably via Venn diagram 2010 Venn diagram consists three circles math statistics subject expertise domain abstract hacking skills three already highly knowledgeable field data science 	Venn_diagram math statistics hacking data_science 
Data science concept used tackle big data includes data cleansing preparation analysis data scientist gathers data multiple sources applies machine learning predictive analytics sentiment analysis extract critical information collected data sets understand data business point view able provide accurate predictions insights used power critical business decisions 	Data_science tackle_data cleansing preparation machine_learning predictive_analytics understand provide_predictions insights 
interested building strong career domain gain key skills three departments analytics programming domain knowledge one level deeper following skills help carve niche data scientist 	three analytics programming domain deeper data_scientist carve_niche 
data analyst usually person basic descriptive statistics visualize data communicate data points conclusions must basic understanding statistics good sense databases ability create new views perception visualize data analytics referred basic level data science   	data_analyst descriptive visualize_data understanding_statistics databases basic_level data_science 
data analyst able take specific question specific topic discuss data looks like represent data relevant stakeholders company looking step role data analyst must gain four key skills 	data_analyst question topic discuss_data four_skills 
Data science umbrella term encompasses data analytics data mining machine learning several related disciplines data scientist expected forecast future based past patterns data analysts extract meaningful insights various data sources data scientist creates questions data analyst finds answers existing set questions 	Data_science data_analytics data_mining machine_learning forecast_future past_patterns insights questions answers 
Machine learning defined practice using algorithms use data learn forecast future trends topic machine learning software comprised statistical analysis predictive analysis used spot patterns catch hidden insights based perceived data good example machine learning implementation machine learning algorithms gather behavioral information f 	Machine_learning algorithms data learn forecast Facebook behavioral 
every user social platform past behavior algorithm predicts interests recommends articles notifications recommends might also products recommends movie based past behaviors machine learning work   learning different perspective statistics critical skills help carve career domain 	user social_platform past behavior algorithm predicts interests recommends statistics 
data science broad term multiple disciplines machine learning fits within data science learning uses various techniques like regression supervised clustering hand data science may may not evolve machine mechanical process main difference two data science broader term not focusses algorithms statistics also takes care entire data processing methodology 	data_science fits_within machine_learning techniques regression supervised_clustering not_machine 
data science seen incorporation multiple parental disciplines including data analytics software engineering data engineering machine learning predictive analytics business analytics includes retrieval collection ingestion transformation large amounts data collectively known science responsible bringing structure big data searching compelling patterns finally advising decision makers bring changes effectively suit business needs analytics machine learning two many tools processes data science uses   	data_analytics software_engineering machine_learning business_analytics includes_retrieval collection_ingestion transformation structure advising 
Data science data analytics machine learning domains industry right combination right skill sets experience help secure strong career trending domains 	Data_science in-demand industry skill_sets experience strong_career 
data full terms confusing expert computer science vital know exact technical details every framework protocol file system analytical tool understand big data help solve problems overview common terms useful managers likely want frequent close communication technical staff preparing data strategy 	full_data confusing vital common_terms communication technical_staff data strategy 
order understand best might want read article first Pig Hive technologies run “Big data” concept concerns collection storage analysis large amounts information Pig Hive come play last means stage process analysis stage data “cleaned” distracting information vital task hand put format insights gleaned 	read_article Pig_Hive technologies “Big_data” analysis data_“cleaned” distracting gleaned_insights 
maintained meaning completely free use modified anyone create custom versions suitable specific tasks 	open-source modified custom tasks 
principle Open Source important fact fundamental big data means technologies available anyone anywhere world little indeed no cost 	Open_Source fundamental big_data available anyone no_cost 
still make money repacking friendly interfaces manuals user support creating custom versions specific jobs industries example distributes version branches original part commercial offering 	Companies make_money friendly_interfaces manuals user_support custom industries Amazon “fork” 
actually essentially allow programmers create tools used query evaluate enormous quantities data spread across distributed networks data spread across many storage quickly efficiently 	allow programmers create_tools query evaluate enormous_data spread networks 
know totally new subject big data case welcome data either structured nicely unstructured 	big_data welcome structured unstructured semi-structured 
Pig Hive carry function known basically makes data structured understood quantified computers find unstructured data difficult understand pass onto humans hopefully draw actionable conclusions 	Pig_Hive MapReduce semi-structured structured understood_computers quantified conclusions 
name implies two procedures first mapping reading data database putting particular format example data huge database refer customer satisfaction ratings refer ages customers 	MapReduce procedures mapping reading_data format satisfaction ages customers 
second reducing carrying mathematical operations data come particular figure example would able work percentage customers 35 rated service highly 	reducing mathematical_operations data figure percentage rated_highly 
Hive Pig offer systems carrying MapReduce functions creating software programs capable automatically completing lots lots MapReduce functions quickly reporting results analysts 	Hive_Pig systems MapReduce_functions software_programs automatically reporting_results analysts 
use programming languages known Pig Latin give programmers quicker access MapReduce functions Hadoop means great quickly building simulated systems tinkered order get output looking g answer question 	languages Pig_Latin MapReduce_functions_Hadoop simulated_systems output answer_question business) 
Hive might little easier use HiveQL declarative language based something many programmers already familiar hand imperative programming language might take little longer learn give programmers flexibility 	Hive_easier HiveQL_declarative SQL imperative 
nutshell tried keep simple possible give understanding actual mechanics operations taking place useful rather technical details want understanding article good place start 	nutshell mechanics in-depth 
really appreciate reading post regularly write big data well management technology issues trends would like read regular posts please click send invite course feel free also connect via 	appreciate reading management technology_trends technology_issues connect 
 Donald Trump tweeted stable genius accused lacking self-awareness journalists comedians truth one perfect probably believe things false 	Pocket Stories fuel_mind mirror Donald_Trump tweeted stable_genius lacking_self-awareness comedians 
 	land_job impress_date staggering_claims only_person_Earth backstage_mind owning_car engine_broke pinpoint 
 rigorous studies thousands people work shown coworkers better recognizing personality affect job performance social scientist want get read personality could ask fill survey stable dependable friendly outgoing curious would much better asking coworkers rate traits often twice accurate see things studies reveal whatever know 	coworkers personality job_performance affect survey friendly curious rate accurate 
 	coworkers irrelevant job_performance blind_spots predictable rate emotional_stability creativity assertiveness 
 good news unique insight emotional stability study people outperformed friends predicting anxious look sound giving speech about felt about bodies better friends strangers met eight minutes forecasting assertive group discussion tried 	unique_insight outperformed predicting anxious look sound giving_speech felt_about_bodies assertive 
 know best traits tough observe easy admit stability internal state friends see vividly although people might want call unstable socially acceptable range fairly wide tend feel terribly anxious outed anxiety observable traits unique knowledge raging extrovert radical introvert need ask pick pretty quickly impromptu karaoke performances complaints husband types loudly 	predict IQ_test less_accurate tough_observe unstable anxiety observable_traits extrovert introvert 
 	smart_creative overestimate pattern_men generosity desirable I’m-not-biased_bias biased_judge vulnerable_to_bias 
	easy_observe hard_admit other_people_mirror Romantic_friends blurrier_vision pesky_desire colleagues reluctant_tell need 
	overcome podcast workplace big_priority evaluations insights see_clearly 
	deep_dives high-intensity astronauts wilderness_together knowing_each_other interviews homes five_hours 
	under_hood tick managers user_manuals best_worst people_rate intense coworkers salary 
situations can’t ignore feedback multiple sources studies one friend little better gauging intelligence creativity four friends significantly better infiltrated writers’ room host told makes 90 percent comedy on stage starts riffing on topics 	can’t_ignore feedback multiple_sources four_friends writers’_room comedy on_stage 
 organized th 	instant_input crowd believable colleagues track_record highly_organized right wrong 
 	Presidents_rated polls teams Trump weigh_in traits desirable intelligence 
wanted know smart political candidates bother wit 	rule_of_intelligence Don’t_talk prove claim Patton_Oswalt person_saying not-funny people_laugh 
 	question intelligent think real_geniuses not_judge 
7 2018 coworkers better rating parts personality coworkers better rating parts personality 	better_coworkers rating personality 
never share email address unsubscribe time page draws published advice expert presenters around world help take presentations merely 	share email_address unsubscribe advice presentations ‘great’ 
bringing together advice wide range people aim cover whole range areas experienced presenter starting ideas help improve 	wide_range advice ideas improve 
hard relaxed nervous time great presenters say important thing connect audience best way let passion subject shine 	relaxed nervous connect_audience passion_subject shine 
honest audience important matters enthusiastic honest audience respond presentation needs built around audience going get out of presentation 	honest audience enthusiastic get_out_of presentation 
prepare presentation always need bear mind audience needs wants know tell giving presentation also need remain focused audience’s response react 	bear_mind audience wants presentation audience’s_response react 
need make easy audience understand respond planning presentation always keep mind question key message three key audience take away 	easy audience understand respond planning_presentation question key_message take_away 
able communicate key message briefly experts recommend others write back business card say 15 words 	communicate key_message briefly 30-second summary’ 15_words 
rule choose important thing keep core message focused brief planning say contribute core message say 	choose_rule core_message focused brief say contribute 
sounds easy surprisingly large number presenters fail smile make eye contact building rapport helps audience connect subject also helps feel less nervous talking individuals great mass unknown people 	presenters_fail smile eye_contact audience_connect less_nervous individuals great_mass people 
help you make sure you turn down lights slide screen visible audience needs see you well slides 	don’t turn_down_lights audience see_you 
beginning presentation crucial need grab attention hold give grace entertain start switch off dull waste explaining entertaining 	beginning crucial grab_attention hold grace entertain switch_off dull waste 
last particularly important stops trying put too much information one slide whole approach avoids dreaded general rule slides sideshow presenter good set slides no use without presenter definitely contain less rather information expressed simply 	too_much one_slide dreaded slides no_use without_presenter less_information 
need provide information create bespoke handout give presentation beings programmed respond stories help us pay attention also remember things use stories presentation audience likely engage remember points afterwards good idea start story wider point need presentation act like story 	handout Human stories pay_attention remember_things engage points start_story 
story trying tell audience create presentation tell effectively tell story focus using least one two basic storytelling mechanics presentation 	story audience presentation storytelling mechanics 
things data objects not ask directly involved topic use focal point story 	Focusing Characters not_things directly_involved focal story 
example instead talking cars could focus specific characters like story needs something change along way ask should be answer going 	cars Changing Dynamic ask should_be answer 
see 15 actionable storytelling tips see post spoken word actually pretty inefficient means communication uses one five senses presenters tend use visual aids help make spoken word better using voice effectively 	storytelling tips spoken_word inefficient_communication five_senses visual voice 
speed talk emphasising changes pitch tone help make voice interesting hold audience’s attention see page 	Varying speed_talk emphasising changes pitch tone voice audience’s_attention 
estimated three quarters communication non-verbal means well tone voice body language crucial getting message across sure giving right messages body language avoid includes crossed arms hands held behind back pockets pacing stage 	estimated three_quarters non-verbal_communication voice_tone body_language message crossed_arms hands_behind 
gestures open confident move naturally around stage among audience possible find presenting difficult hard calm relaxed 	open_gestures move_naturally stage audience calm relaxed hard 
option start concentrating breathing Slow down make sure breathing fully sure continue pause breath occasionally presentation 	fully_breathing Slow_down breath_pause presentation 
ideas see page Presentation Nerves bring relax almost certainly present better actually start enjoy audience respond engage better presentations improve exponentially confidence well worth try 	ideas Coping Presentation_Nerves relax better enjoy audience_respond engage exponentially 
guide boost presentation skills learning preparation delivery questions aspects giving effective presentations 	boost presentation skills preparation delivery questions 
ago realized job longer itch scratch months work knew unsettling itch increased dissatisfaction discontent wasn’t specific feeling something wasn’t quite right fact amounted almost feeling emptiness 	job itch_scratch unsettling dissatisfaction wasn’t_right emptiness 
feeling tried everything worked harder went vacation chatted friends pondered long hard drank beer drank less beer got fit read books matter tried itch grew steadily stronger could longer ignore 	feeling worked_harder vacation chatted pondered drank_beer fit read_books itch 
message telling time change time take next step next challenge felt every cell 	message time change next_challenge every_cell 
problem absolutely no idea no concept capable work opportunities potential choices incredibly frustrating feeling felt like huge wave building beneath me unable catch unable use power actually felt bit scared 	no_idea problem frustrating huge_wave beneath_me power scared 
graduating joined shiny fresh management trainee excited ambitious soon found running sales territory learning ropes selling beer working clubs time deals closed personal relationships business savvy education could sup mild smoke best 	graduating shiny excited ambitious learning selling_beer relationships business_savvy education 
hallway smelt boiled cabbage old rag mats one end coloured poster large indoor display tacked wall depicted simply enormous face metre wide face man heavy black moustache ruggedly handsome features 	smelt boiled_cabbage old_rag coloured_poster wall enormous_face metre_wide black_moustache man 
made stairs use trying lift best times seldom working present electric current cut off daylight hours part economy drive preparation Hate Week 	stairs lift electric_current_off daylight economy Hate_Week 
flat seven flights varicose ulcer right ankle went slowly resting several times way landing opposite poster enormous face gazed wall 	seven_flat thirty-nine varicose_ulcer right_ankle slowly resting landing enormous_face gazed 
one pictures contrived eyes follow move BIG BROTHER caption beneath ran 	pictures contrived eyes_follow BIG_BROTHER WATCHING caption 
flat fruity voice reading list figures something withthe production voice came oblong metal plaque like dulled mirror formed part surface wall turned switch voice sank somewhat though words still distinguishable instrument telescreen could dimmed way shutting completely 	fruity voice reading metal_plaque dulled_mirror wall switch sank telescreen 
moved window smallish frail figure meagreness body merely emphasized blue overalls uniform party hair fair face naturally sanguine skin roughened coarse soap blunt razor blades cold winter ended 	window frail_figure body blue_overalls party_uniform sanguine_face skin_roughened blunt_razor winter 
even shut world looked cold street little eddies wind whirling dust torn paper spirals though sun shining sky harsh blue seemed no colour anything except posters plastered everywhere face gazed every commanding corner one immediately opposite caption said dark eyes looked deep 	cold_world wind_eddies dust_paper_spirals shining_sun blue_sky no_colour blackmoustachio’d every_corner BROTHER 
street level another poster torn one corner flapped fitfully wind alternately covering uncovering thesingle word far distance helicopter skimmed roofs hovered instant like bluebottle darted away curving flight police patrol snooping windows patrols matter however mattered 	poster flapped_fitfully wind far_helicopter skimmed hovered darted curving_flight police 
back voice telescreen still babbling away overfulfilment telescreen received transmitted simultaneously sound made level low whisper would picked moreover long remained within field vision metal plaque commanded could seen well heard course way knowing whether watched given moment 	telescreen babbling received_transmitted whisper seen heard given_moment 
often system individual wire guesswork even conceivable watched everybody time rate could plug wire whenever wanted live live habit became instinct assumption every sound made overheard except darkness every movement scrutinized 	guesswork conceivable habit instinct every_sound_overheard movement_scrutinized 
kept back turned telescreen safer though well knew even back revealing kilometre away Ministry Truth place work towered vast white grimy landscape thought sort vague distaste chief city third populous provinces 	telescreen revealing_back Ministry_Truth towered_white grimy_landscape distaste chief_city London Oceania 
tried squeeze out childhood memory tell whether always quite like always vistas rotting houses sides shored baulks timber windows patched cardboard roofs corrugated iron crazy garden walls sagging directions bombed sites plaster dust swirled air straggled heaps places bombs cleared larger patch sprung sordid colonies wooden dwellings like 	squeeze_out childhood_memory London always rotting_houses windows_cardboard bombed plaster_dust rubble; 
use could remember nothing remained childhood except series bright-lit tableaux occurring background mostly unintelligible startlingly different object sight enormous pyramidal structure glittering white concrete soaring terrace terrace 300 metres air stood possible read picked white face elegant lettering three slogans Party 	childhood bright-lit_tableaux startlingly_different pyramidal white_concrete elegant_lettering slogans_Party 
WAR PEACE FREEDOM SLAVERY IGNORANCE STRENGTHThe Ministry Truth contained said three thousand rooms ground level corresponding ramifications three buildings similar appearance size completely dwarf surrounding architecture roof could see four simultaneously homes four entire apparatus government divided 	WAR_PEACE FREEDOM_SLAVERY IGNORANCE_STRENGTHThe Ministry_Truth three_thousand_rooms dwarf_architecture four_buildings Ministries apparatus 
concerned news entertainment education fine arts concerned war maintained law order responsible economic affairs names 	Truth news_entertainment education fine_arts Love law_order Plenty economic 
Love really frightening one no windows never inside Love within half kilometre placeimpossible enter except official business penetrating maze entanglements steel doors hidden machine-gun nests streets leading outer barriers roamed guards black uniforms armed jointed truncheons 	Love_frightening no_windows enter_maze barbed-wire steel_doors hidden_machine-gun streets_leading gorilla-faced truncheons 
turned round abruptly set features expression quiet optimism advisable wear facing telescreen crossed room tiny kitchen leaving time day sacrificed lunch canteen aware food kitchen except hunk dark-coloured bread got saved breakfast 	expression quiet_optimism telescreen tiny_kitchen canteen_lunch sacrificed dark-coloured_bread saved breakfast 
took shelf bottle colourless liquid plain white label marked GIN gave sickly oily smell poured nearly teacupful nerved shock gulped like dose medicine 	shelf colourless_liquid sickly oily smell poured_GIN nerved_shock teacupful medicine 
face turned scarlet water ran eyes stuff like nitric acid moreover swallowing one sensation hit back head rubber club next moment however burning belly died world began look cheerful took cigarette crumpled packet marked incautiously held upright whereupon tobacco fell floor 	scarlet_face eyes_water nitric_acid swallowing rubber_hit belly_burning cheerful_world cigarette VICTORY 
next successful went back sat small table stood left telescreen table drawer took penholder bottle ink thick blank book red back marbled cover 	sat small_table telescreen table_drawer penholder ink blank_book red 
reason telescreen unusual position placed normal end wall could command whole room thelonger wall opposite window one side shallow alcove sitting flats built probably intended hold bookshelves sitting alcove keeping well back able remain outside range telescreen far sight went 	telescreen_position hold_bookshelves outside range_telescreen sight 
could heard course long stayed present position could not seen partly unusual geography room suggested thing 	heard not_seen room suggested 
also suggested book taken drawer peculiarly beautiful book smooth creamy paper little yellowed age kind manufactured least forty years past could guess however book much older 	suggested_drawer beautiful_book smooth_paper forty_years_past older 
seen lying window frowsy little junk-shop slummy quarter town quarter not stricken immediately overwhelming desire possess members supposed not go intoordinary shops free rule not strictly kept various things shoelaces razor blades impossible toget hold way 	window_junk-shop slummy_town overwhelming_desire possess not_supposed shoelaces razor_blades shops 
given quick glance street slipped inside bought book two dollars fifty time conscious wanting particular purpose carried guiltily home briefcase nothing written compromising possession 	slipped_inside quick_glance bought_book two_dollars_fifty not conscious wanting guiltily_home compromising 
thing open diary illegal (nothing illegal since no longer laws) detected reasonably certain would punished death least years forced-labour camp 	diary (nothing_illegal no_laws) detected punished_death forced-labour_camp 
fitted nib penholder sucked get grease pen archaic instrument seldom used even signatures procured one furtively difficulty simply feeling beautiful creamy paper deserved written real nib instead scratched 	sucked_grease pen_archaic signatures furtively difficulty creamy_paper deserved_nib 
used writing hand short notes usual dictate everything course impossible present purpose dipped pen ink faltered asecond 	hand_writing dictate speak-write purpose dipped_pen faltered 
knew place well museum used propaganda displays various kinds scale models rocket bombs waxwork tableaux illustrating enemyatrocities like used called supplemented old man recollect fields anywhere parts 	museum propaganda rocket_bombs waxwork_tableaux 
did not buy picture would even incongruous possession glass paperweight impossible carry home unless taken frame lingered minutes talking old man whose name discovered not one might gathered inscription 	picture did_not_buy incongruous_paperweight lingered old_man talking 
wars could won lost ruling class could completely irresponsible war becomes literally continuous also ceases dangerous war continuous thing military necessity progress cease palpable facts denied disregarded seen researches could called scientific still carried purposes war essentially kind daydreaming failure show results important 	wars won_lost continuous_war palpable_facts denied disregarded scientific_researches war_purposes daydreaming 
even military efficiency no longer needed efficient except Thought Police thethree super-states unconquerable effect separate universe within almost perversion thought safely practised exerts pressure needs ofeveryday life need eat drink get shelter clothing avoid swallowing poison stepping windows like 	efficiency no_needed Thought_Police unconquerable_super-states Reality life_needs eat_shelter_clothing avoid_poison 
sam promising swordsman among year crop paladin trainees knows brash cocky unbeatable sword well almost kingdom thule best hope violence wrought demons problem thought weak proven trials prove training yard provided tristan found partner looked heavenwards sighed suppose tapped shoulder flat hello author note welcome world please first chapter 1 prologue unedited included version eventually attempt publish swordsman Brash cocky kingdom demons violence 	cocky_swordsman kingdom demons violence 
labor love past 15 months enjoy reading much enjoyed writing hearing readers try respond every comment away psa love enjoy reading comment 	love enjoy reading comment 
 2012 sally slater rights reserved cover  2013 hayley john dedicated mother   371 post daemoniorum p lady samantha haywood watched swordsmen perch old oak tree skinny legs swinging back forth hugged thick trunk balance giant grew several feet castle wall giving perfect view importantly heavy branches dense foliage hid father two men circled swords extended even could see rivulets sweat rolling sir daniel face drops dying red tunic deep maroon breathing hard though noted arm beginning shake exertion opponent form held strong two men swords tree rivulets sweat red tunic breathing hard arm shake opponent's strong 	two_men swords tree rivulets_sweat red_tunic breathing_hard arm_shake opponent's_strong 
large audience gathered spectators shouting encouragements cheering reengaged metallic sound overpowering hum crowd large audience spectators shouting metallic sound sword 	large_audience spectators_shouting metallic_sound sword 
fierce fighter recognized bladesmaster untrained eye tell outclassed man like extension effortlessly meeting swing blade darting teasing flicks connected often lightness moved and gracefulness ripostes reminded sort exotic dance beautiful thing ever seen fierce fighter--the outclassed opponent teasing gracefulness exotic dance beautiful 	fierce_outclassed opponent teasing gracefulness exotic_dance beautiful 
moment later knelt one knee throat hushed stunned blademaster defeat golden haired dropped clasped hand pulling knelt knee sword throat stunned defeat golden haired clasped hand 	knelt_knee sword_throat stunned defeat golden_haired clasped_hand 
fought knight said surprisingly young baritone dipped head honor mine lyons suspected would last saw whisk talk politics whatever talked behind closed doors gone morrow big cities permanently residence and  the elite warriors seldom stayed town night dipped head fought honor last saw closed doors 	dipped_head fought honor last_saw closed_doors 
